"Ticket";"Symbol";"Type";"Open time";"Open price";"Size";"Close time";"Close price";"Profit/Loss";"Balance";"Sample type";"Close type";"MAE ($)";"MFE ($)";"Time in trade";"Comment"
"1";"USDJPY_M1";"Sell";"2013.09.02 08:00:00";"99.329";"0.10000";"2013.09.02 23:00:00";"99.679";"-35.00";"9965.00";"IST";"SL";"-35.00";"19.30";"15h 0m";""
"2";"USDJPY_M1";"Sell";"2013.09.03 00:00:00";"99.569";"0.10000";"2013.09.05 05:00:00";"99.919";"-35.00";"9930.00";"IST";"SL";"-35.00";"38.20";"2d 5h 0m";""
"3";"USDJPY_M1";"Sell";"2013.09.05 09:00:00";"99.879";"0.10000";"2013.09.05 22:00:00";"100.229";"-35.00";"9895.00";"IST";"SL";"-35.00";"19.90";"13h 0m";""
"4";"USDJPY_M1";"Sell";"2013.09.05 23:00:00";"100.158";"0.10000";"2013.09.08 21:00:00";"99.725";"43.30";"9938.30";"IST";"End Of Friday";"0.00";"159.80";"2d 22h 0m";""
"5";"USDJPY_M1";"Buy";"2013.09.08 21:00:00";"99.725";"0.10000";"2013.09.09 08:00:00";"99.375";"-35.00";"9903.30";"IST";"SL";"-35.00";"37.70";"11h 0m";""
"6";"USDJPY_M1";"Sell";"2013.09.10 04:00:00";"99.567";"0.10000";"2013.09.10 06:00:00";"99.917";"-35.00";"9868.30";"IST";"SL";"-35.00";"0.80";"2h 0m";""
"7";"USDJPY_M1";"Sell";"2013.09.10 18:00:00";"100.295";"0.10000";"2013.09.15 21:00:00";"98.669";"162.60";"10030.90";"IST";"End Of Friday";"-33.10";"162.60";"5d 3h 0m";""
"8";"USDJPY_M1";"Buy";"2013.09.16 05:00:00";"98.950";"0.10000";"2013.09.18 18:00:00";"98.600";"-35.00";"9995.90";"IST";"SL";"-35.00";"43.20";"2d 13h 0m";""
"9";"USDJPY_M1";"Buy";"2013.09.18 19:00:00";"97.978";"0.10000";"2013.09.22 21:00:00";"99.248";"127.00";"10122.90";"IST";"End Of Friday";"-21.90";"168.90";"4d 2h 0m";""
"10";"USDJPY_M1";"Buy";"2013.09.23 14:00:00";"98.841";"0.10000";"2013.09.24 14:00:00";"98.491";"-35.00";"10087.90";"IST";"SL";"-35.00";"33.30";"1d 0h 0m";""
"11";"USDJPY_M1";"Sell";"2013.09.24 17:00:00";"98.863";"0.10000";"2013.09.29 21:00:00";"97.694";"116.90";"10204.80";"IST";"End Of Friday";"-29.00";"116.90";"5d 4h 0m";""
"12";"USDJPY_M1";"Buy";"2013.09.29 21:00:00";"97.694";"0.10000";"2013.10.02 07:00:00";"97.344";"-35.00";"10169.80";"IST";"SL";"-35.00";"103.00";"2d 10h 0m";""
"13";"USDJPY_M1";"Buy";"2013.10.02 12:00:00";"97.557";"0.10000";"2013.10.02 13:00:00";"97.207";"-35.00";"10134.80";"IST";"SL";"-35.00";"0.00";"1h 0m";""
"14";"USDJPY_M1";"Buy";"2013.10.02 14:00:00";"97.245";"0.10000";"2013.10.06 21:00:00";"97.215";"-3.00";"10131.80";"IST";"End Of Friday";"-31.60";"62.60";"4d 7h 0m";""
"15";"USDJPY_M1";"Buy";"2013.10.07 16:00:00";"97.046";"0.10000";"2013.10.07 20:00:00";"96.696";"-35.00";"10096.80";"IST";"SL";"-35.00";"0.00";"4h 0m";""
"16";"USDJPY_M1";"Buy";"2013.10.08 03:00:00";"96.825";"0.10000";"2013.10.13 21:00:00";"98.240";"141.50";"10238.30";"IST";"End Of Friday";"-0.20";"176.70";"5d 18h 0m";""
"17";"USDJPY_M1";"Buy";"2013.10.14 18:00:00";"98.428";"0.10000";"2013.10.15 20:00:00";"98.078";"-35.00";"10203.30";"IST";"SL";"-35.00";"27.60";"1d 2h 0m";""
"18";"USDJPY_M1";"Sell";"2013.10.15 21:00:00";"98.173";"0.10000";"2013.10.15 23:00:00";"98.523";"-35.00";"10168.30";"IST";"SL";"-35.00";"1.80";"2h 0m";""
"19";"USDJPY_M1";"Sell";"2013.10.16 01:00:00";"98.531";"0.10000";"2013.10.16 14:00:00";"98.881";"-35.00";"10133.30";"IST";"SL";"-35.00";"26.60";"13h 0m";""
"20";"USDJPY_M1";"Buy";"2013.10.16 15:00:00";"98.882";"0.10000";"2013.10.17 04:00:00";"98.532";"-35.00";"10098.30";"IST";"SL";"-35.00";"12.20";"13h 0m";""
"21";"USDJPY_M1";"Sell";"2013.10.17 05:00:00";"98.549";"0.10000";"2013.10.20 21:00:00";"97.844";"70.50";"10168.80";"IST";"End Of Friday";"0.00";"97.20";"3d 16h 0m";""
"22";"USDJPY_M1";"Buy";"2013.10.21 00:00:00";"97.975";"0.10000";"2013.10.23 03:00:00";"97.625";"-35.00";"10133.80";"IST";"SL";"-35.00";"50.70";"2d 3h 0m";""
"23";"USDJPY_M1";"Sell";"2013.10.23 06:00:00";"97.363";"0.10000";"2013.10.27 21:00:00";"97.713";"-35.00";"10098.80";"IST";"SL";"-35.00";"40.10";"4d 15h 0m";""
"24";"USDJPY_M1";"Sell";"2013.10.28 04:00:00";"97.616";"0.10000";"2013.10.29 11:00:00";"97.966";"-35.00";"10063.80";"IST";"SL";"-35.00";"13.60";"1d 7h 0m";""
"25";"USDJPY_M1";"Buy";"2013.10.29 14:00:00";"97.927";"0.10000";"2013.11.03 22:00:00";"98.822";"89.50";"10153.30";"IST";"End Of Friday";"-11.90";"92.30";"5d 8h 0m";""
"26";"USDJPY_M1";"Sell";"2013.11.03 23:00:00";"98.692";"0.10000";"2013.11.07 13:00:00";"99.042";"-35.00";"10118.30";"IST";"SL";"-35.00";"50.70";"3d 14h 0m";""
"27";"USDJPY_M1";"Buy";"2013.11.07 15:00:00";"99.254";"0.10000";"2013.11.07 16:00:00";"98.904";"-35.00";"10083.30";"IST";"SL";"-35.00";"0.60";"1h 0m";""
"28";"USDJPY_M1";"Sell";"2013.11.07 18:00:00";"98.502";"0.10000";"2013.11.08 13:00:00";"98.852";"-35.00";"10048.30";"IST";"SL";"-35.00";"87.40";"19h 0m";""
"29";"USDJPY_M1";"Buy";"2013.11.08 14:00:00";"98.588";"0.10000";"2013.11.08 21:00:00";"99.157";"56.90";"10105.20";"IST";"End Of Friday (Time)";"0.00";"63.30";"7h 0m";""
"30";"USDJPY_M1";"Sell";"2013.11.11 02:00:00";"99.050";"0.10000";"2013.11.12 01:00:00";"99.400";"-35.00";"10070.20";"IST";"SL";"-35.00";"10.70";"23h 0m";""
"31";"USDJPY_M1";"Sell";"2013.11.12 02:00:00";"99.483";"0.10000";"2013.11.14 08:00:00";"99.833";"-35.00";"10035.20";"IST";"SL";"-35.00";"36.30";"2d 6h 0m";""
"32";"USDJPY_M1";"Sell";"2013.11.14 15:00:00";"99.944";"0.10000";"2013.11.15 01:00:00";"100.294";"-35.00";"10000.20";"IST";"SL";"-35.00";"14.00";"10h 0m";""
"33";"USDJPY_M1";"Sell";"2013.11.15 06:00:00";"100.109";"0.10000";"2013.11.15 21:00:00";"100.237";"-12.80";"9987.40";"IST";"End Of Friday (Time)";"-34.10";"15.20";"15h 0m";""
"34";"USDJPY_M1";"Sell";"2013.11.18 03:00:00";"100.238";"0.10000";"2013.11.21 06:00:00";"100.588";"-35.00";"9952.40";"IST";"SL";"-35.00";"64.90";"3d 3h 0m";""
"35";"USDJPY_M1";"Sell";"2013.11.21 14:00:00";"100.925";"0.10000";"2013.11.21 23:00:00";"101.275";"-35.00";"9917.40";"IST";"SL";"-35.00";"3.30";"9h 0m";""
"36";"USDJPY_M1";"Sell";"2013.11.22 00:00:00";"101.291";"0.10000";"2013.11.22 21:00:00";"101.346";"-5.50";"9911.90";"IST";"End Of Friday (Time)";"-8.10";"31.70";"21h 0m";""
"37";"USDJPY_M1";"Buy";"2013.11.25 03:00:00";"101.656";"0.10000";"2013.11.26 17:00:00";"101.306";"-35.00";"9876.90";"IST";"SL";"-35.00";"26.10";"1d 14h 0m";""
"38";"USDJPY_M1";"Sell";"2013.11.26 18:00:00";"101.269";"0.10000";"2013.11.27 05:00:00";"101.619";"-35.00";"9841.90";"IST";"SL";"-35.00";"10.30";"11h 0m";""
"39";"USDJPY_M1";"Buy";"2013.11.27 06:00:00";"101.518";"0.10000";"2013.11.29 21:00:00";"102.410";"89.20";"9931.10";"IST";"End Of Friday (Time)";"0.00";"109.10";"2d 15h 0m";""
"40";"USDJPY_M1";"Sell";"2013.12.01 22:00:00";"102.496";"0.10000";"2013.12.02 11:00:00";"102.846";"-35.00";"9896.10";"IST";"SL";"-35.00";"25.20";"13h 0m";""
"41";"USDJPY_M1";"Sell";"2013.12.02 22:00:00";"102.937";"0.10000";"2013.12.03 04:00:00";"103.287";"-35.00";"9861.10";"IST";"SL";"-35.00";"8.70";"6h 0m";""
"42";"USDJPY_M1";"Sell";"2013.12.03 09:00:00";"103.106";"0.10000";"2013.12.06 21:00:00";"102.889";"21.70";"9882.80";"IST";"End Of Friday (Time)";"0.00";"146.60";"3d 12h 0m";""
"43";"USDJPY_M1";"Sell";"2013.12.08 22:00:00";"103.014";"0.10000";"2013.12.09 23:00:00";"103.364";"-35.00";"9847.80";"IST";"SL";"-35.00";"10.50";"1d 1h 0m";""
"44";"USDJPY_M1";"Sell";"2013.12.10 01:00:00";"103.282";"0.10000";"2013.12.12 22:00:00";"103.632";"-35.00";"9812.80";"IST";"SL";"-35.00";"110.90";"2d 21h 0m";""
"45";"USDJPY_M1";"Sell";"2013.12.13 04:00:00";"103.752";"0.10000";"2013.12.13 21:00:00";"103.243";"50.90";"9863.70";"IST";"End Of Friday (Time)";"-18.70";"74.10";"17h 0m";""
"46";"USDJPY_M1";"Buy";"2013.12.16 09:00:00";"103.126";"0.10000";"2013.12.17 15:00:00";"102.776";"-35.00";"9828.70";"IST";"SL";"-35.00";"1.80";"1d 6h 0m";""
"47";"USDJPY_M1";"Buy";"2013.12.17 23:00:00";"102.592";"0.10000";"2013.12.20 00:00:00";"104.392";"180.00";"10008.70";"IST";"PT";"0.00";"180.00";"2d 1h 0m";""
"48";"USDJPY_M1";"Sell";"2013.12.20 08:00:00";"104.422";"0.10000";"2013.12.20 21:00:00";"104.082";"34.00";"10042.70";"IST";"End Of Friday (Time)";"-23.20";"54.40";"13h 0m";""
"49";"USDJPY_M1";"Buy";"2013.12.23 01:00:00";"104.083";"0.10000";"2013.12.27 21:00:00";"105.179";"109.60";"10152.30";"IST";"End Of Friday (Time)";"-31.30";"109.80";"4d 20h 0m";""
"50";"USDJPY_M1";"Sell";"2013.12.30 00:00:00";"105.302";"0.10000";"2014.01.03 21:00:00";"104.797";"50.50";"10202.80";"IST";"End Of Friday (Time)";"-15.90";"120.80";"4d 21h 0m";""
"51";"USDJPY_M1";"Buy";"2014.01.05 22:00:00";"104.848";"0.10000";"2014.01.06 01:00:00";"104.498";"-35.00";"10167.80";"IST";"SL";"-35.00";"10.10";"3h 0m";""
"52";"USDJPY_M1";"Sell";"2014.01.06 03:00:00";"104.311";"0.10000";"2014.01.06 08:00:00";"104.661";"-35.00";"10132.80";"IST";"SL";"-35.00";"5.90";"5h 0m";""
"53";"USDJPY_M1";"Buy";"2014.01.06 10:00:00";"104.576";"0.10000";"2014.01.06 17:00:00";"104.226";"-35.00";"10097.80";"IST";"SL";"-35.00";"26.30";"7h 0m";""
"54";"USDJPY_M1";"Sell";"2014.01.06 18:00:00";"104.041";"0.10000";"2014.01.07 00:00:00";"104.391";"-35.00";"10062.80";"IST";"SL";"-35.00";"5.90";"6h 0m";""
"55";"USDJPY_M1";"Buy";"2014.01.07 03:00:00";"104.339";"0.10000";"2014.01.10 15:00:00";"103.989";"-35.00";"10027.80";"IST";"SL";"-35.00";"99.60";"3d 12h 0m";""
"56";"USDJPY_M1";"Sell";"2014.01.10 16:00:00";"104.146";"0.10000";"2014.01.10 21:00:00";"104.092";"5.40";"10033.20";"IST";"End Of Friday (Time)";"-3.10";"18.00";"5h 0m";""
"57";"USDJPY_M1";"Buy";"2014.01.12 23:00:00";"104.097";"0.10000";"2014.01.13 01:00:00";"103.747";"-35.00";"9998.20";"IST";"SL";"-35.00";"2.20";"2h 0m";""
"58";"USDJPY_M1";"Buy";"2014.01.13 03:00:00";"103.459";"0.10000";"2014.01.13 14:00:00";"103.109";"-35.00";"9963.20";"IST";"SL";"-35.00";"11.00";"11h 0m";""
"59";"USDJPY_M1";"Buy";"2014.01.13 15:00:00";"103.256";"0.10000";"2014.01.13 18:00:00";"102.906";"-35.00";"9928.20";"IST";"SL";"-35.00";"12.90";"3h 0m";""
"60";"USDJPY_M1";"Buy";"2014.01.13 19:00:00";"102.962";"0.10000";"2014.01.16 00:00:00";"104.762";"180.00";"10108.20";"IST";"PT";"-10.70";"180.00";"2d 5h 0m";""
"61";"USDJPY_M1";"Sell";"2014.01.16 02:00:00";"104.755";"0.10000";"2014.01.17 21:00:00";"104.299";"45.60";"10153.80";"IST";"End Of Friday (Time)";"-18.50";"58.90";"1d 19h 0m";""
"62";"USDJPY_M1";"Buy";"2014.01.20 07:00:00";"104.134";"0.10000";"2014.01.23 13:00:00";"103.784";"-35.00";"10118.80";"IST";"SL";"-35.00";"70.70";"3d 6h 0m";""
"63";"USDJPY_M1";"Buy";"2014.01.24 00:00:00";"103.404";"0.10000";"2014.01.24 08:00:00";"103.054";"-35.00";"10083.80";"IST";"SL";"-35.00";"17.90";"8h 0m";""
"64";"USDJPY_M1";"Buy";"2014.01.24 09:00:00";"103.047";"0.10000";"2014.01.24 10:00:00";"102.697";"-35.00";"10048.80";"IST";"SL";"-35.00";"3.30";"1h 0m";""
"65";"USDJPY_M1";"Buy";"2014.01.24 16:00:00";"102.375";"0.10000";"2014.01.24 21:00:00";"102.248";"-12.70";"10036.10";"IST";"End Of Friday (Time)";"-18.90";"12.30";"5h 0m";""
"66";"USDJPY_M1";"Buy";"2014.01.26 22:00:00";"102.244";"0.10000";"2014.01.26 22:00:00";"101.894";"-35.00";"10001.10";"IST";"SL";"-35.00";"0.00";"0s";""
"67";"USDJPY_M1";"Buy";"2014.01.26 23:00:00";"102.055";"0.10000";"2014.01.31 21:00:00";"102.161";"10.60";"10011.70";"IST";"End Of Friday (Time)";"-21.20";"138.70";"4d 22h 0m";""
"68";"USDJPY_M1";"Buy";"2014.02.02 22:00:00";"102.018";"0.10000";"2014.02.03 15:00:00";"101.668";"-35.00";"9976.70";"IST";"SL";"-35.00";"39.10";"17h 0m";""
"69";"USDJPY_M1";"Buy";"2014.02.04 00:00:00";"101.201";"0.10000";"2014.02.04 06:00:00";"100.851";"-35.00";"9941.70";"IST";"SL";"-35.00";"17.70";"6h 0m";""
"70";"USDJPY_M1";"Buy";"2014.02.04 07:00:00";"101.043";"0.10000";"2014.02.07 21:00:00";"102.264";"122.10";"10063.80";"IST";"End Of Friday (Time)";"-24.20";"153.60";"3d 14h 0m";""
"71";"USDJPY_M1";"Sell";"2014.02.09 22:00:00";"102.531";"0.10000";"2014.02.14 21:00:00";"101.822";"70.90";"10134.70";"IST";"End Of Friday (Time)";"-18.90";"94.30";"4d 23h 0m";""
"72";"USDJPY_M1";"Buy";"2014.02.17 04:00:00";"101.674";"0.10000";"2014.02.21 21:00:00";"102.559";"88.50";"10223.20";"IST";"End Of Friday (Time)";"-14.60";"115.30";"4d 17h 0m";""
"73";"USDJPY_M1";"Sell";"2014.02.23 22:00:00";"102.471";"0.10000";"2014.02.28 21:00:00";"101.796";"67.50";"10290.70";"IST";"End Of Friday (Time)";"-22.90";"89.90";"4d 23h 0m";""
"74";"USDJPY_M1";"Buy";"2014.03.03 05:00:00";"101.442";"0.10000";"2014.03.07 13:00:00";"103.242";"180.00";"10470.70";"IST";"PT";"-24.20";"180.00";"4d 8h 0m";""
"75";"USDJPY_M1";"Buy";"2014.03.07 16:00:00";"103.339";"0.10000";"2014.03.07 21:00:00";"103.305";"-3.40";"10467.30";"IST";"End Of Friday (Time)";"-12.40";"7.60";"5h 0m";""
"76";"USDJPY_M1";"Sell";"2014.03.09 22:00:00";"103.132";"0.10000";"2014.03.14 12:00:00";"101.332";"180.00";"10647.30";"IST";"PT";"-31.50";"180.00";"4d 14h 0m";""
"77";"USDJPY_M1";"Buy";"2014.03.14 18:00:00";"101.409";"0.10000";"2014.03.16 21:00:00";"101.267";"-14.20";"10633.10";"IST";"End Of Friday";"-14.20";"0.80";"2d 3h 0m";""
"78";"USDJPY_M1";"Buy";"2014.03.16 22:00:00";"101.415";"0.10000";"2014.03.23 21:00:00";"102.140";"72.50";"10705.60";"IST";"End Of Friday";"-13.80";"126.70";"6d 23h 0m";""
"79";"USDJPY_M1";"Buy";"2014.03.23 23:00:00";"102.240";"0.10000";"2014.03.26 20:00:00";"101.890";"-35.00";"10670.60";"IST";"SL";"-35.00";"40.70";"2d 21h 0m";""
"80";"USDJPY_M1";"Buy";"2014.03.27 00:00:00";"101.937";"0.10000";"2014.03.30 21:00:00";"102.928";"99.10";"10769.70";"IST";"End Of Friday";"-21.80";"104.20";"3d 21h 0m";""
"81";"USDJPY_M1";"Sell";"2014.03.30 21:00:00";"102.928";"0.10000";"2014.03.31 09:00:00";"103.278";"-35.00";"10734.70";"IST";"SL";"-35.00";"11.40";"12h 0m";""
"82";"USDJPY_M1";"Sell";"2014.03.31 16:00:00";"102.984";"0.10000";"2014.04.01 01:00:00";"103.334";"-35.00";"10699.70";"IST";"SL";"-35.00";"0.00";"9h 0m";""
"83";"USDJPY_M1";"Sell";"2014.04.01 02:00:00";"103.251";"0.10000";"2014.04.01 14:00:00";"103.601";"-35.00";"10664.70";"IST";"SL";"-35.00";"2.40";"12h 0m";""
"84";"USDJPY_M1";"Sell";"2014.04.01 15:00:00";"103.568";"0.10000";"2014.04.02 01:00:00";"103.918";"-35.00";"10629.70";"IST";"SL";"-35.00";"9.00";"10h 0m";""
"85";"USDJPY_M1";"Sell";"2014.04.02 02:00:00";"103.869";"0.10000";"2014.04.06 21:00:00";"103.293";"57.60";"10687.30";"IST";"End Of Friday";"-27.80";"65.10";"4d 19h 0m";""
"86";"USDJPY_M1";"Buy";"2014.04.07 00:00:00";"103.340";"0.10000";"2014.04.08 00:00:00";"102.990";"-35.00";"10652.30";"IST";"SL";"-35.00";"0.00";"1d 0h 0m";""
"87";"USDJPY_M1";"Buy";"2014.04.08 02:00:00";"102.874";"0.10000";"2014.04.08 09:00:00";"102.524";"-35.00";"10617.30";"IST";"SL";"-35.00";"18.10";"7h 0m";""
"88";"USDJPY_M1";"Buy";"2014.04.08 23:00:00";"101.902";"0.10000";"2014.04.10 09:00:00";"101.552";"-35.00";"10582.30";"IST";"SL";"-35.00";"25.70";"1d 10h 0m";""
"89";"USDJPY_M1";"Buy";"2014.04.10 13:00:00";"101.862";"0.10000";"2014.04.10 14:00:00";"101.512";"-35.00";"10547.30";"IST";"SL";"-35.00";"11.00";"1h 0m";""
"90";"USDJPY_M1";"Buy";"2014.04.10 15:00:00";"101.538";"0.10000";"2014.04.13 21:00:00";"101.620";"8.20";"10555.50";"IST";"End Of Friday";"-21.50";"33.20";"3d 6h 0m";""
"91";"USDJPY_M1";"Sell";"2014.04.14 01:00:00";"101.441";"0.10000";"2014.04.14 11:00:00";"101.791";"-35.00";"10520.50";"IST";"SL";"-35.00";"0.20";"10h 0m";""
"92";"USDJPY_M1";"Sell";"2014.04.14 16:00:00";"101.816";"0.10000";"2014.04.16 02:00:00";"102.166";"-35.00";"10485.50";"IST";"SL";"-35.00";"29.40";"1d 10h 0m";""
"93";"USDJPY_M1";"Buy";"2014.04.16 03:00:00";"102.251";"0.10000";"2014.04.17 02:00:00";"101.901";"-35.00";"10450.50";"IST";"SL";"-35.00";"11.40";"23h 0m";""
"94";"USDJPY_M1";"Sell";"2014.04.17 03:00:00";"101.941";"0.10000";"2014.04.17 12:00:00";"102.291";"-35.00";"10415.50";"IST";"SL";"-35.00";"0.00";"9h 0m";""
"95";"USDJPY_M1";"Buy";"2014.04.17 13:00:00";"102.200";"0.10000";"2014.04.20 21:00:00";"102.431";"23.10";"10438.60";"IST";"End Of Friday";"-8.40";"37.10";"3d 8h 0m";""
"96";"USDJPY_M1";"Buy";"2014.04.21 02:00:00";"102.660";"0.10000";"2014.04.23 09:00:00";"102.310";"-35.00";"10403.60";"IST";"SL";"-35.00";"6.30";"2d 7h 0m";""
"97";"USDJPY_M1";"Sell";"2014.04.23 12:00:00";"102.256";"0.10000";"2014.04.24 12:00:00";"102.606";"-35.00";"10368.60";"IST";"SL";"-35.00";"2.10";"1d 0h 0m";""
"98";"USDJPY_M1";"Buy";"2014.04.24 15:00:00";"102.252";"0.10000";"2014.04.27 21:00:00";"102.180";"-7.20";"10361.40";"IST";"End Of Friday";"-29.00";"24.50";"3d 6h 0m";""
"99";"USDJPY_M1";"Buy";"2014.04.27 21:00:00";"102.200";"0.10000";"2014.05.04 21:00:00";"102.139";"-6.10";"10355.30";"IST";"End Of Friday";"-16.90";"82.00";"7d 0h 0m";""
"100";"USDJPY_M1";"Buy";"2014.05.05 00:00:00";"102.229";"0.10000";"2014.05.05 01:00:00";"101.879";"-35.00";"10320.30";"IST";"SL";"-35.00";"0.00";"1h 0m";""
"101";"USDJPY_M1";"Buy";"2014.05.05 08:00:00";"102.090";"0.10000";"2014.05.06 11:00:00";"101.740";"-35.00";"10285.30";"IST";"SL";"-35.00";"9.90";"1d 3h 0m";""
"102";"USDJPY_M1";"Buy";"2014.05.06 21:00:00";"101.704";"0.10000";"2014.05.11 21:00:00";"101.849";"14.50";"10299.80";"IST";"End Of Friday";"-27.30";"30.20";"5d 0h 0m";""
"103";"USDJPY_M1";"Sell";"2014.05.12 07:00:00";"101.886";"0.10000";"2014.05.12 22:00:00";"102.236";"-35.00";"10264.80";"IST";"SL";"-35.00";"1.60";"15h 0m";""
"104";"USDJPY_M1";"Sell";"2014.05.13 02:00:00";"102.203";"0.10000";"2014.05.18 21:00:00";"101.550";"65.30";"10330.10";"IST";"End Of Friday";"-18.00";"87.00";"5d 19h 0m";""
"105";"USDJPY_M1";"Buy";"2014.05.18 21:00:00";"101.550";"0.10000";"2014.05.19 09:00:00";"101.200";"-35.00";"10295.10";"IST";"SL";"-35.00";"4.80";"12h 0m";""
"106";"USDJPY_M1";"Sell";"2014.05.19 12:00:00";"101.221";"0.10000";"2014.05.20 01:00:00";"101.571";"-35.00";"10260.10";"IST";"SL";"-35.00";"9.10";"13h 0m";""
"107";"USDJPY_M1";"Buy";"2014.05.20 04:00:00";"101.572";"0.10000";"2014.05.20 13:00:00";"101.222";"-35.00";"10225.10";"IST";"SL";"-35.00";"0.00";"9h 0m";""
"108";"USDJPY_M1";"Sell";"2014.05.20 16:00:00";"101.265";"0.10000";"2014.05.21 18:00:00";"101.615";"-35.00";"10190.10";"IST";"SL";"-35.00";"42.40";"1d 2h 0m";""
"109";"USDJPY_M1";"Sell";"2014.05.21 21:00:00";"101.364";"0.10000";"2014.05.22 04:00:00";"101.714";"-35.00";"10155.10";"IST";"SL";"-35.00";"0.00";"7h 0m";""
"110";"USDJPY_M1";"Sell";"2014.05.22 09:00:00";"101.621";"0.10000";"2014.05.23 10:00:00";"101.971";"-35.00";"10120.10";"IST";"SL";"-35.00";"12.70";"1d 1h 0m";""
"111";"USDJPY_M1";"Sell";"2014.05.23 15:00:00";"101.818";"0.10000";"2014.05.25 21:00:00";"101.936";"-11.80";"10108.30";"IST";"End Of Friday";"-20.60";"2.90";"2d 6h 0m";""
"112";"USDJPY_M1";"Sell";"2014.05.25 23:00:00";"101.955";"0.10000";"2014.06.01 21:00:00";"101.874";"8.10";"10116.40";"IST";"End Of Friday";"-20.50";"50.60";"6d 22h 0m";""
"113";"USDJPY_M1";"Sell";"2014.06.02 08:00:00";"101.999";"0.10000";"2014.06.02 15:00:00";"102.349";"-35.00";"10081.40";"IST";"SL";"-35.00";"0.80";"7h 0m";""
"114";"USDJPY_M1";"Sell";"2014.06.02 17:00:00";"102.383";"0.10000";"2014.06.04 03:00:00";"102.733";"-35.00";"10046.40";"IST";"SL";"-35.00";"9.20";"1d 10h 0m";""
"115";"USDJPY_M1";"Sell";"2014.06.04 07:00:00";"102.658";"0.10000";"2014.06.08 21:00:00";"102.517";"14.10";"10060.50";"IST";"End Of Friday";"-12.00";"52.40";"4d 14h 0m";""
"116";"USDJPY_M1";"Sell";"2014.06.09 03:00:00";"102.517";"0.10000";"2014.06.15 21:00:00";"102.090";"42.70";"10103.20";"IST";"End Of Friday";"-9.60";"89.10";"6d 18h 0m";""
"117";"USDJPY_M1";"Sell";"2014.06.16 00:00:00";"101.974";"0.10000";"2014.06.18 05:00:00";"102.324";"-35.00";"10068.20";"IST";"SL";"-35.00";"23.30";"2d 5h 0m";""
"118";"USDJPY_M1";"Sell";"2014.06.18 10:00:00";"102.225";"0.10000";"2014.06.22 21:00:00";"102.101";"12.40";"10080.60";"IST";"End Of Friday";"-14.70";"46.50";"4d 11h 0m";""
"119";"USDJPY_M1";"Sell";"2014.06.22 21:00:00";"102.081";"0.10000";"2014.06.29 21:00:00";"101.403";"67.80";"10148.40";"IST";"End Of Friday";"-10.60";"74.70";"7d 0h 0m";""
"120";"USDJPY_M1";"Buy";"2014.06.29 21:00:00";"101.403";"0.10000";"2014.07.06 21:00:00";"102.053";"65.00";"10213.40";"IST";"End Of Friday";"-16.60";"86.30";"7d 0h 0m";""
"121";"USDJPY_M1";"Buy";"2014.07.07 00:00:00";"102.139";"0.10000";"2014.07.07 17:00:00";"101.789";"-35.00";"10178.40";"IST";"SL";"-35.00";"6.20";"17h 0m";""
"122";"USDJPY_M1";"Buy";"2014.07.07 20:00:00";"101.869";"0.10000";"2014.07.08 13:00:00";"101.519";"-35.00";"10143.40";"IST";"SL";"-35.00";"2.80";"17h 0m";""
"123";"USDJPY_M1";"Buy";"2014.07.08 20:00:00";"101.556";"0.10000";"2014.07.10 12:00:00";"101.206";"-35.00";"10108.40";"IST";"SL";"-35.00";"30.10";"1d 16h 0m";""
"124";"USDJPY_M1";"Sell";"2014.07.10 15:00:00";"101.284";"0.10000";"2014.07.13 21:00:00";"101.331";"-4.70";"10103.70";"IST";"End Of Friday";"-12.20";"4.80";"3d 6h 0m";""
"125";"USDJPY_M1";"Sell";"2014.07.13 23:00:00";"101.364";"0.10000";"2014.07.15 14:00:00";"101.714";"-35.00";"10068.70";"IST";"SL";"-35.00";"0.70";"1d 15h 0m";""
"126";"USDJPY_M1";"Sell";"2014.07.15 16:00:00";"101.622";"0.10000";"2014.07.20 21:00:00";"101.345";"27.70";"10096.40";"IST";"End Of Friday";"-19.00";"51.50";"5d 5h 0m";""
"127";"USDJPY_M1";"Sell";"2014.07.21 03:00:00";"101.280";"0.10000";"2014.07.24 10:00:00";"101.630";"-35.00";"10061.40";"IST";"SL";"-35.00";"6.30";"3d 7h 0m";""
"128";"USDJPY_M1";"Buy";"2014.07.24 11:00:00";"101.652";"0.10000";"2014.07.27 21:00:00";"101.769";"11.70";"10073.10";"IST";"End Of Friday";"-4.50";"28.60";"3d 10h 0m";""
"129";"USDJPY_M1";"Sell";"2014.07.28 01:00:00";"101.755";"0.10000";"2014.07.29 12:00:00";"102.105";"-35.00";"10038.10";"IST";"SL";"-35.00";"0.00";"1d 11h 0m";""
"130";"USDJPY_M1";"Sell";"2014.07.29 20:00:00";"102.103";"0.10000";"2014.07.30 12:00:00";"102.453";"-35.00";"10003.10";"IST";"SL";"-35.00";"4.60";"16h 0m";""
"131";"USDJPY_M1";"Buy";"2014.07.30 15:00:00";"102.822";"0.10000";"2014.08.01 14:00:00";"102.472";"-35.00";"9968.10";"IST";"SL";"-35.00";"26.20";"1d 23h 0m";""
"132";"USDJPY_M1";"Sell";"2014.08.01 15:00:00";"102.472";"0.10000";"2014.08.03 21:00:00";"102.566";"-9.40";"9958.70";"IST";"End Of Friday";"-14.90";"5.10";"2d 6h 0m";""
"133";"USDJPY_M1";"Buy";"2014.08.03 21:00:00";"102.566";"0.10000";"2014.08.06 16:00:00";"102.216";"-35.00";"9923.70";"IST";"SL";"-35.00";"35.90";"2d 19h 0m";""
"134";"USDJPY_M1";"Sell";"2014.08.06 19:00:00";"102.044";"0.10000";"2014.08.07 05:00:00";"102.394";"-35.00";"9888.70";"IST";"SL";"-35.00";"0.30";"10h 0m";""
"135";"USDJPY_M1";"Buy";"2014.08.07 06:00:00";"102.380";"0.10000";"2014.08.07 15:00:00";"102.030";"-35.00";"9853.70";"IST";"SL";"-35.00";"2.10";"9h 0m";""
"136";"USDJPY_M1";"Buy";"2014.08.08 11:00:00";"101.862";"0.10000";"2014.08.10 21:00:00";"102.181";"31.90";"9885.60";"IST";"End Of Friday";"-15.20";"31.90";"2d 10h 0m";""
"137";"USDJPY_M1";"Buy";"2014.08.10 21:00:00";"102.201";"0.10000";"2014.08.17 21:00:00";"102.325";"12.40";"9898.00";"IST";"End Of Friday";"-17.70";"51.50";"7d 0h 0m";""
"138";"USDJPY_M1";"Buy";"2014.08.18 00:00:00";"102.435";"0.10000";"2014.08.24 21:00:00";"104.235";"180.00";"10078.00";"IST";"PT";"-18.80";"180.00";"6d 21h 0m";""
"139";"USDJPY_M1";"Sell";"2014.08.24 21:00:00";"104.264";"0.10000";"2014.08.31 21:00:00";"104.185";"7.90";"10085.90";"IST";"End Of Friday";"-2.80";"68.90";"7d 0h 0m";""
"140";"USDJPY_M1";"Sell";"2014.08.31 22:00:00";"104.176";"0.10000";"2014.09.02 01:00:00";"104.526";"-35.00";"10050.90";"IST";"SL";"-35.00";"5.50";"1d 3h 0m";""
"141";"USDJPY_M1";"Sell";"2014.09.02 10:00:00";"104.923";"0.10000";"2014.09.02 23:00:00";"105.273";"-35.00";"10015.90";"IST";"SL";"-35.00";"2.20";"13h 0m";""
"142";"USDJPY_M1";"Sell";"2014.09.03 01:00:00";"105.183";"0.10000";"2014.09.04 23:00:00";"105.533";"-35.00";"9980.90";"IST";"SL";"-35.00";"42.20";"1d 22h 0m";""
"143";"USDJPY_M1";"Sell";"2014.09.05 04:00:00";"105.342";"0.10000";"2014.09.07 21:00:00";"105.001";"34.10";"10015.00";"IST";"End Of Friday";"-4.90";"64.10";"2d 17h 0m";""
"144";"USDJPY_M1";"Buy";"2014.09.08 02:00:00";"105.093";"0.10000";"2014.09.11 04:00:00";"106.893";"180.00";"10195.00";"IST";"PT";"-6.20";"180.00";"3d 2h 0m";""
"145";"USDJPY_M1";"Sell";"2014.09.11 05:00:00";"106.917";"0.10000";"2014.09.12 01:00:00";"107.267";"-35.00";"10160.00";"IST";"SL";"-35.00";"24.60";"20h 0m";""
"146";"USDJPY_M1";"Sell";"2014.09.12 07:00:00";"107.149";"0.10000";"2014.09.14 21:00:00";"107.220";"-7.10";"10152.90";"IST";"End Of Friday";"-25.40";"2.90";"2d 14h 0m";""
"147";"USDJPY_M1";"Sell";"2014.09.15 04:00:00";"107.174";"0.10000";"2014.09.17 14:00:00";"107.524";"-35.00";"10117.90";"IST";"SL";"-35.00";"34.40";"2d 10h 0m";""
"148";"USDJPY_M1";"Sell";"2014.09.17 15:00:00";"107.485";"0.10000";"2014.09.17 18:00:00";"107.835";"-35.00";"10082.90";"IST";"SL";"-35.00";"8.50";"3h 0m";""
"149";"USDJPY_M1";"Buy";"2014.09.17 21:00:00";"108.390";"0.10000";"2014.09.21 21:00:00";"109.026";"63.60";"10146.50";"IST";"End Of Friday";"-1.70";"106.90";"4d 0h 0m";""
"150";"USDJPY_M1";"Sell";"2014.09.22 16:00:00";"108.881";"0.10000";"2014.09.24 23:00:00";"109.231";"-35.00";"10111.50";"IST";"SL";"-35.00";"61.00";"2d 7h 0m";""
"151";"USDJPY_M1";"Sell";"2014.09.25 03:00:00";"109.161";"0.10000";"2014.09.26 18:00:00";"109.511";"-35.00";"10076.50";"IST";"SL";"-35.00";"66.40";"1d 15h 0m";""
"152";"USDJPY_M1";"Sell";"2014.09.29 00:00:00";"109.400";"0.10000";"2014.09.29 05:00:00";"109.750";"-35.00";"10041.50";"IST";"SL";"-35.00";"11.70";"5h 0m";""
"153";"USDJPY_M1";"Sell";"2014.09.29 06:00:00";"109.661";"0.10000";"2014.10.01 02:00:00";"110.011";"-35.00";"10006.50";"IST";"SL";"-35.00";"51.20";"1d 20h 0m";""
"154";"USDJPY_M1";"Sell";"2014.10.01 08:00:00";"109.845";"0.10000";"2014.10.02 16:00:00";"108.045";"180.00";"10186.50";"IST";"PT";"-15.50";"180.00";"1d 8h 0m";""
"155";"USDJPY_M1";"Buy";"2014.10.02 21:00:00";"108.440";"0.10000";"2014.10.05 21:00:00";"109.707";"126.70";"10313.20";"IST";"End Of Friday";"-8.80";"146.20";"3d 0h 0m";""
"156";"USDJPY_M1";"Sell";"2014.10.05 22:00:00";"109.782";"0.10000";"2014.10.07 19:00:00";"107.982";"180.00";"10493.20";"IST";"PT";"-8.70";"180.00";"1d 21h 0m";""
"157";"USDJPY_M1";"Buy";"2014.10.07 20:00:00";"108.059";"0.10000";"2014.10.09 06:00:00";"107.709";"-35.00";"10458.20";"IST";"SL";"-35.00";"68.20";"1d 10h 0m";""
"158";"USDJPY_M1";"Buy";"2014.10.09 11:00:00";"107.643";"0.10000";"2014.10.12 21:00:00";"107.548";"-9.50";"10448.70";"IST";"End Of Friday";"-11.50";"54.10";"3d 10h 0m";""
"159";"USDJPY_M1";"Buy";"2014.10.13 07:00:00";"107.381";"0.10000";"2014.10.13 20:00:00";"107.031";"-35.00";"10413.70";"IST";"SL";"-35.00";"19.20";"13h 0m";""
"160";"USDJPY_M1";"Buy";"2014.10.14 02:00:00";"107.231";"0.10000";"2014.10.14 09:00:00";"106.881";"-35.00";"10378.70";"IST";"SL";"-35.00";"8.00";"7h 0m";""
"161";"USDJPY_M1";"Sell";"2014.10.14 11:00:00";"106.869";"0.10000";"2014.10.14 22:00:00";"107.219";"-35.00";"10343.70";"IST";"SL";"-35.00";"17.70";"11h 0m";""
"162";"USDJPY_M1";"Buy";"2014.10.15 01:00:00";"107.264";"0.10000";"2014.10.15 11:00:00";"106.914";"-35.00";"10308.70";"IST";"SL";"-35.00";"23.00";"10h 0m";""
"163";"USDJPY_M1";"Sell";"2014.10.15 13:00:00";"106.288";"0.10000";"2014.10.17 10:00:00";"106.638";"-35.00";"10273.70";"IST";"SL";"-35.00";"107.30";"1d 21h 0m";""
"164";"USDJPY_M1";"Sell";"2014.10.17 14:00:00";"106.668";"0.10000";"2014.10.19 21:00:00";"107.018";"-35.00";"10238.70";"IST";"SL";"-35.00";"6.70";"2d 7h 0m";""
"165";"USDJPY_M1";"Sell";"2014.10.19 21:00:00";"107.203";"0.10000";"2014.10.23 08:00:00";"107.553";"-35.00";"10203.70";"IST";"SL";"-35.00";"93.20";"3d 11h 0m";""
"166";"USDJPY_M1";"Sell";"2014.10.23 10:00:00";"107.537";"0.10000";"2014.10.23 12:00:00";"107.887";"-35.00";"10168.70";"IST";"SL";"-35.00";"8.80";"2h 0m";""
"167";"USDJPY_M1";"Sell";"2014.10.23 21:00:00";"108.262";"0.10000";"2014.10.26 21:00:00";"108.359";"-9.70";"10159.00";"IST";"End Of Friday";"-9.70";"45.90";"3d 0h 0m";""
"168";"USDJPY_M1";"Buy";"2014.10.27 14:00:00";"107.854";"0.10000";"2014.10.31 04:00:00";"109.654";"180.00";"10339.00";"IST";"PT";"-24.80";"180.00";"3d 14h 0m";""
"169";"USDJPY_M1";"Buy";"2014.10.31 07:00:00";"111.154";"0.10000";"2014.11.02 22:00:00";"112.699";"154.50";"10493.50";"IST";"End Of Friday";"-13.30";"154.50";"2d 15h 0m";""
"170";"USDJPY_M1";"Sell";"2014.11.02 22:00:00";"112.699";"0.10000";"2014.11.03 10:00:00";"113.049";"-35.00";"10458.50";"IST";"SL";"-35.00";"10.90";"12h 0m";""
"171";"USDJPY_M1";"Sell";"2014.11.03 11:00:00";"113.281";"0.10000";"2014.11.03 11:00:00";"113.631";"-35.00";"10423.50";"IST";"SL";"-35.00";"2.10";"0s";""
"172";"USDJPY_M1";"Sell";"2014.11.03 12:00:00";"113.621";"0.10000";"2014.11.03 15:00:00";"113.971";"-35.00";"10388.50";"IST";"SL";"-35.00";"12.80";"3h 0m";""
"173";"USDJPY_M1";"Sell";"2014.11.03 19:00:00";"113.817";"0.10000";"2014.11.05 05:00:00";"114.167";"-35.00";"10353.50";"IST";"SL";"-35.00";"63.20";"1d 10h 0m";""
"174";"USDJPY_M1";"Buy";"2014.11.05 07:00:00";"114.210";"0.10000";"2014.11.07 21:00:00";"114.610";"40.00";"10393.50";"IST";"End Of Friday (Time)";"-15.10";"136.20";"2d 14h 0m";""
"175";"USDJPY_M1";"Buy";"2014.11.10 02:00:00";"114.243";"0.10000";"2014.11.10 07:00:00";"113.893";"-35.00";"10358.50";"IST";"SL";"-35.00";"5.20";"5h 0m";""
"176";"USDJPY_M1";"Buy";"2014.11.10 08:00:00";"114.025";"0.10000";"2014.11.11 07:00:00";"115.825";"180.00";"10538.50";"IST";"PT";"-8.50";"180.00";"23h 0m";""
"177";"USDJPY_M1";"Sell";"2014.11.11 15:00:00";"115.686";"0.10000";"2014.11.14 00:00:00";"116.036";"-35.00";"10503.50";"IST";"SL";"-35.00";"78.10";"2d 9h 0m";""
"178";"USDJPY_M1";"Sell";"2014.11.14 04:00:00";"116.039";"0.10000";"2014.11.14 07:00:00";"116.389";"-35.00";"10468.50";"IST";"SL";"-35.00";"8.90";"3h 0m";""
"179";"USDJPY_M1";"Sell";"2014.11.14 09:00:00";"116.290";"0.10000";"2014.11.14 13:00:00";"116.640";"-35.00";"10433.50";"IST";"SL";"-35.00";"0.00";"4h 0m";""
"180";"USDJPY_M1";"Sell";"2014.11.14 18:00:00";"116.337";"0.10000";"2014.11.14 21:00:00";"116.303";"3.40";"10436.90";"IST";"End Of Friday (Time)";"-2.70";"23.90";"3h 0m";""
"181";"USDJPY_M1";"Sell";"2014.11.16 22:00:00";"116.451";"0.10000";"2014.11.16 23:00:00";"116.801";"-35.00";"10401.90";"IST";"SL";"-35.00";"8.20";"1h 0m";""
"182";"USDJPY_M1";"Sell";"2014.11.17 03:00:00";"115.777";"0.10000";"2014.11.17 08:00:00";"116.127";"-35.00";"10366.90";"IST";"SL";"-35.00";"29.80";"5h 0m";""
"183";"USDJPY_M1";"Buy";"2014.11.17 12:00:00";"116.341";"0.10000";"2014.11.19 22:00:00";"118.141";"180.00";"10546.90";"IST";"PT";"-25.60";"180.00";"2d 10h 0m";""
"184";"USDJPY_M1";"Sell";"2014.11.20 04:00:00";"118.357";"0.10000";"2014.11.20 05:00:00";"118.707";"-35.00";"10511.90";"IST";"SL";"-35.00";"0.40";"1h 0m";""
"185";"USDJPY_M1";"Sell";"2014.11.20 10:00:00";"118.472";"0.10000";"2014.11.21 21:00:00";"117.741";"73.10";"10585.00";"IST";"End Of Friday (Time)";"0.00";"109.70";"1d 11h 0m";""
"186";"USDJPY_M1";"Sell";"2014.11.24 19:00:00";"118.321";"0.10000";"2014.11.28 15:00:00";"118.671";"-35.00";"10550.00";"IST";"SL";"-35.00";"106.40";"3d 20h 0m";""
"187";"USDJPY_M1";"Sell";"2014.12.01 00:00:00";"118.850";"0.10000";"2014.12.02 12:00:00";"119.200";"-35.00";"10515.00";"IST";"SL";"-35.00";"97.00";"1d 12h 0m";""
"188";"USDJPY_M1";"Sell";"2014.12.02 18:00:00";"119.223";"0.10000";"2014.12.03 14:00:00";"119.573";"-35.00";"10480.00";"IST";"SL";"-35.00";"7.50";"20h 0m";""
"189";"USDJPY_M1";"Sell";"2014.12.03 15:00:00";"119.675";"0.10000";"2014.12.04 14:00:00";"120.025";"-35.00";"10445.00";"IST";"SL";"-35.00";"5.40";"23h 0m";""
"190";"USDJPY_M1";"Sell";"2014.12.04 16:00:00";"119.718";"0.10000";"2014.12.05 04:00:00";"120.068";"-35.00";"10410.00";"IST";"SL";"-35.00";"36.00";"12h 0m";""
"191";"USDJPY_M1";"Buy";"2014.12.05 16:00:00";"121.426";"0.10000";"2014.12.05 21:00:00";"121.437";"1.10";"10411.10";"IST";"End Of Friday (Time)";"-14.30";"13.90";"5h 0m";""
"192";"USDJPY_M1";"Sell";"2014.12.07 22:00:00";"121.590";"0.10000";"2014.12.09 06:00:00";"119.790";"180.00";"10591.10";"IST";"PT";"-27.30";"180.00";"1d 8h 0m";""
"193";"USDJPY_M1";"Buy";"2014.12.09 12:00:00";"120.093";"0.10000";"2014.12.09 12:00:00";"119.743";"-35.00";"10556.10";"IST";"SL";"-35.00";"0.00";"0s";""
"194";"USDJPY_M1";"Buy";"2014.12.09 13:00:00";"119.703";"0.10000";"2014.12.09 14:00:00";"119.353";"-35.00";"10521.10";"IST";"SL";"-35.00";"4.60";"1h 0m";""
"195";"USDJPY_M1";"Buy";"2014.12.09 20:00:00";"119.494";"0.10000";"2014.12.10 04:00:00";"119.144";"-35.00";"10486.10";"IST";"SL";"-35.00";"42.10";"8h 0m";""
"196";"USDJPY_M1";"Buy";"2014.12.10 09:00:00";"119.157";"0.10000";"2014.12.10 13:00:00";"118.807";"-35.00";"10451.10";"IST";"SL";"-35.00";"24.90";"4h 0m";""
"197";"USDJPY_M1";"Buy";"2014.12.11 01:00:00";"117.641";"0.10000";"2014.12.11 16:00:00";"119.441";"180.00";"10631.10";"IST";"PT";"0.00";"180.00";"15h 0m";""
"198";"USDJPY_M1";"Sell";"2014.12.11 22:00:00";"118.639";"0.10000";"2014.12.11 23:00:00";"118.989";"-35.00";"10596.10";"IST";"SL";"-35.00";"0.00";"1h 0m";""
"199";"USDJPY_M1";"Sell";"2014.12.12 01:00:00";"118.916";"0.10000";"2014.12.12 21:00:00";"118.669";"24.70";"10620.80";"IST";"End Of Friday (Time)";"-31.00";"84.60";"20h 0m";""
"200";"USDJPY_M1";"Buy";"2014.12.15 03:00:00";"118.763";"0.10000";"2014.12.15 06:00:00";"118.413";"-35.00";"10585.80";"IST";"SL";"-35.00";"0.70";"3h 0m";""
"201";"USDJPY_M1";"Sell";"2014.12.15 16:00:00";"118.386";"0.10000";"2014.12.16 08:00:00";"116.586";"180.00";"10765.80";"IST";"PT";"0.00";"180.00";"16h 0m";""
"202";"USDJPY_M1";"Buy";"2014.12.16 09:00:00";"116.715";"0.10000";"2014.12.16 09:00:00";"116.365";"-35.00";"10730.80";"IST";"SL";"-35.00";"1.00";"0s";""
"203";"USDJPY_M1";"Buy";"2014.12.16 10:00:00";"116.542";"0.10000";"2014.12.16 11:00:00";"116.192";"-35.00";"10695.80";"IST";"SL";"-35.00";"29.60";"1h 0m";""
"204";"USDJPY_M1";"Buy";"2014.12.16 13:00:00";"115.883";"0.10000";"2014.12.16 16:00:00";"117.683";"180.00";"10875.80";"IST";"PT";"-2.00";"180.00";"3h 0m";""
"205";"USDJPY_M1";"Buy";"2014.12.16 17:00:00";"117.313";"0.10000";"2014.12.16 20:00:00";"116.963";"-35.00";"10840.80";"IST";"SL";"-35.00";"15.70";"3h 0m";""
"206";"USDJPY_M1";"Buy";"2014.12.16 21:00:00";"116.645";"0.10000";"2014.12.16 21:00:00";"116.295";"-35.00";"10805.80";"IST";"SL";"-35.00";"7.20";"0s";""
"207";"USDJPY_M1";"Buy";"2014.12.16 22:00:00";"116.422";"0.10000";"2014.12.17 19:00:00";"118.222";"180.00";"10985.80";"IST";"PT";"0.00";"180.00";"21h 0m";""
"208";"USDJPY_M1";"Sell";"2014.12.18 03:00:00";"118.579";"0.10000";"2014.12.18 07:00:00";"118.929";"-35.00";"10950.80";"IST";"SL";"-35.00";"21.30";"4h 0m";""
"209";"USDJPY_M1";"Sell";"2014.12.18 08:00:00";"118.688";"0.10000";"2014.12.18 13:00:00";"119.038";"-35.00";"10915.80";"IST";"SL";"-35.00";"40.90";"5h 0m";""
"210";"USDJPY_M1";"Sell";"2014.12.18 14:00:00";"119.236";"0.10000";"2014.12.19 16:00:00";"119.586";"-35.00";"10880.80";"IST";"SL";"-35.00";"63.90";"1d 2h 0m";""
"211";"USDJPY_M1";"Sell";"2014.12.19 17:00:00";"119.573";"0.10000";"2014.12.19 21:00:00";"119.555";"1.80";"10882.60";"IST";"End Of Friday (Time)";"-4.00";"10.50";"4h 0m";""
"212";"USDJPY_M1";"Sell";"2014.12.21 23:00:00";"119.525";"0.10000";"2014.12.22 08:00:00";"119.875";"-35.00";"10847.60";"IST";"SL";"-35.00";"19.30";"9h 0m";""
"213";"USDJPY_M1";"Sell";"2014.12.22 14:00:00";"119.926";"0.10000";"2014.12.23 13:00:00";"120.276";"-35.00";"10812.60";"IST";"SL";"-35.00";"7.20";"23h 0m";""
"214";"USDJPY_M1";"Sell";"2014.12.23 20:00:00";"120.730";"0.10000";"2014.12.26 21:00:00";"120.411";"31.90";"10844.50";"IST";"End Of Friday (Time)";"-11.60";"71.50";"3d 1h 0m";""
"215";"USDJPY_M1";"Sell";"2014.12.29 01:00:00";"120.485";"0.10000";"2015.01.02 21:00:00";"120.491";"-0.60";"10843.90";"IST";"End Of Friday (Time)";"-27.60";"160.20";"4d 20h 0m";""
"216";"USDJPY_M1";"Sell";"2015.01.04 22:00:00";"120.499";"0.10000";"2015.01.06 06:00:00";"118.699";"180.00";"11023.90";"IST";"PT";"-16.60";"180.00";"1d 8h 0m";""
"217";"USDJPY_M1";"Buy";"2015.01.06 07:00:00";"118.816";"0.10000";"2015.01.06 16:00:00";"118.466";"-35.00";"10988.90";"IST";"SL";"-35.00";"57.50";"9h 0m";""
"218";"USDJPY_M1";"Buy";"2015.01.06 22:00:00";"118.404";"0.10000";"2015.01.09 21:00:00";"118.556";"15.20";"11004.10";"IST";"End Of Friday (Time)";"-2.00";"155.90";"2d 23h 0m";""
"219";"USDJPY_M1";"Buy";"2015.01.12 03:00:00";"118.413";"0.10000";"2015.01.13 00:00:00";"118.063";"-35.00";"10969.10";"IST";"SL";"-35.00";"90.50";"21h 0m";""
"220";"USDJPY_M1";"Sell";"2015.01.13 03:00:00";"117.963";"0.10000";"2015.01.13 04:00:00";"118.313";"-35.00";"10934.10";"IST";"SL";"-35.00";"13.20";"1h 0m";""
"221";"USDJPY_M1";"Buy";"2015.01.13 06:00:00";"118.697";"0.10000";"2015.01.13 07:00:00";"118.347";"-35.00";"10899.10";"IST";"SL";"-35.00";"15.20";"1h 0m";""
"222";"USDJPY_M1";"Buy";"2015.01.13 08:00:00";"118.262";"0.10000";"2015.01.13 17:00:00";"117.912";"-35.00";"10864.10";"IST";"SL";"-35.00";"50.70";"9h 0m";""
"223";"USDJPY_M1";"Buy";"2015.01.14 10:00:00";"117.035";"0.10000";"2015.01.14 13:00:00";"116.685";"-35.00";"10829.10";"IST";"SL";"-35.00";"13.20";"3h 0m";""
"224";"USDJPY_M1";"Buy";"2015.01.14 14:00:00";"116.339";"0.10000";"2015.01.15 22:00:00";"115.989";"-35.00";"10794.10";"IST";"SL";"-35.00";"160.30";"1d 8h 0m";""
"225";"USDJPY_M1";"Buy";"2015.01.16 03:00:00";"115.997";"0.10000";"2015.01.16 21:00:00";"117.604";"160.70";"10954.80";"IST";"End Of Friday (Time)";"-2.00";"176.50";"18h 0m";""
"226";"USDJPY_M1";"Sell";"2015.01.19 00:00:00";"117.593";"0.10000";"2015.01.20 00:00:00";"117.943";"-35.00";"10919.80";"IST";"SL";"-35.00";"65.20";"1d 0h 0m";""
"227";"USDJPY_M1";"Sell";"2015.01.20 10:00:00";"118.282";"0.10000";"2015.01.20 11:00:00";"118.632";"-35.00";"10884.80";"IST";"SL";"-35.00";"0.40";"1h 0m";""
"228";"USDJPY_M1";"Sell";"2015.01.20 12:00:00";"118.686";"0.10000";"2015.01.23 21:00:00";"117.831";"85.50";"10970.30";"IST";"End Of Friday (Time)";"-20.10";"148.30";"3d 9h 0m";""
"229";"USDJPY_M1";"Buy";"2015.01.26 03:00:00";"117.639";"0.10000";"2015.01.28 20:00:00";"117.289";"-35.00";"10935.30";"IST";"SL";"-35.00";"102.00";"2d 17h 0m";""
"230";"USDJPY_M1";"Sell";"2015.01.28 22:00:00";"117.523";"0.10000";"2015.01.29 02:00:00";"117.873";"-35.00";"10900.30";"IST";"SL";"-35.00";"12.20";"4h 0m";""
"231";"USDJPY_M1";"Buy";"2015.01.29 03:00:00";"118.023";"0.10000";"2015.01.29 05:00:00";"117.673";"-35.00";"10865.30";"IST";"SL";"-35.00";"0.00";"2h 0m";""
"232";"USDJPY_M1";"Sell";"2015.01.29 08:00:00";"117.706";"0.10000";"2015.01.29 12:00:00";"118.056";"-35.00";"10830.30";"IST";"SL";"-35.00";"0.00";"4h 0m";""
"233";"USDJPY_M1";"Buy";"2015.01.29 16:00:00";"118.083";"0.10000";"2015.01.30 08:00:00";"117.733";"-35.00";"10795.30";"IST";"SL";"-35.00";"40.60";"16h 0m";""
"234";"USDJPY_M1";"Buy";"2015.01.30 17:00:00";"117.470";"0.10000";"2015.01.30 21:00:00";"117.412";"-5.80";"10789.50";"IST";"End Of Friday (Time)";"-12.50";"18.90";"4h 0m";""
"235";"USDJPY_M1";"Buy";"2015.02.01 22:00:00";"116.950";"0.10000";"2015.02.06 14:00:00";"118.750";"180.00";"10969.50";"IST";"PT";"-7.40";"180.00";"4d 16h 0m";""
"236";"USDJPY_M1";"Buy";"2015.02.06 16:00:00";"119.024";"0.10000";"2015.02.06 21:00:00";"118.842";"-18.20";"10951.30";"IST";"End Of Friday (Time)";"-21.20";"19.70";"5h 0m";""
"237";"USDJPY_M1";"Sell";"2015.02.08 22:00:00";"119.015";"0.10000";"2015.02.10 13:00:00";"119.365";"-35.00";"10916.30";"IST";"SL";"-35.00";"66.30";"1d 15h 0m";""
"238";"USDJPY_M1";"Buy";"2015.02.10 16:00:00";"119.288";"0.10000";"2015.02.12 08:00:00";"118.938";"-35.00";"10881.30";"IST";"SL";"-35.00";"118.80";"1d 16h 0m";""
"239";"USDJPY_M1";"Sell";"2015.02.12 09:00:00";"119.642";"0.10000";"2015.02.13 21:00:00";"118.807";"83.50";"10964.80";"IST";"End Of Friday (Time)";"-25.80";"121.20";"1d 12h 0m";""
"240";"USDJPY_M1";"Buy";"2015.02.16 08:00:00";"118.625";"0.10000";"2015.02.17 00:00:00";"118.275";"-35.00";"10929.80";"IST";"SL";"-35.00";"2.20";"16h 0m";""
"241";"USDJPY_M1";"Buy";"2015.02.17 01:00:00";"118.336";"0.10000";"2015.02.20 21:00:00";"119.069";"73.30";"11003.10";"IST";"End Of Friday (Time)";"-3.50";"107.90";"3d 20h 0m";""
"242";"USDJPY_M1";"Sell";"2015.02.23 03:00:00";"119.036";"0.10000";"2015.02.24 08:00:00";"119.386";"-35.00";"10968.10";"IST";"SL";"-35.00";"27.80";"1d 5h 0m";""
"243";"USDJPY_M1";"Sell";"2015.02.24 15:00:00";"119.703";"0.10000";"2015.02.27 21:00:00";"119.653";"5.00";"10973.10";"IST";"End Of Friday (Time)";"-11.50";"105.80";"3d 6h 0m";""
"244";"USDJPY_M1";"Sell";"2015.03.01 23:00:00";"119.686";"0.10000";"2015.03.02 15:00:00";"120.036";"-35.00";"10938.10";"IST";"SL";"-35.00";"0.30";"16h 0m";""
"245";"USDJPY_M1";"Sell";"2015.03.02 16:00:00";"120.122";"0.10000";"2015.03.06 13:00:00";"120.472";"-35.00";"10903.10";"IST";"SL";"-35.00";"72.30";"3d 21h 0m";""
"246";"USDJPY_M1";"Buy";"2015.03.06 16:00:00";"121.177";"0.10000";"2015.03.06 18:00:00";"120.827";"-35.00";"10868.10";"IST";"SL";"-35.00";"0.00";"2h 0m";""
"247";"USDJPY_M1";"Sell";"2015.03.08 21:00:00";"120.827";"0.10000";"2015.03.09 15:00:00";"121.177";"-35.00";"10833.10";"IST";"SL";"-35.00";"19.50";"18h 0m";""
"248";"USDJPY_M1";"Sell";"2015.03.10 07:00:00";"121.725";"0.10000";"2015.03.15 21:00:00";"121.368";"35.70";"10868.80";"IST";"End Of Friday";"-29.90";"105.10";"5d 14h 0m";""
"249";"USDJPY_M1";"Buy";"2015.03.16 17:00:00";"121.300";"0.10000";"2015.03.18 15:00:00";"120.950";"-35.00";"10833.80";"IST";"SL";"-35.00";"21.90";"1d 22h 0m";""
"250";"USDJPY_M1";"Buy";"2015.03.18 20:00:00";"120.085";"0.10000";"2015.03.19 00:00:00";"119.735";"-35.00";"10798.80";"IST";"SL";"-35.00";"21.50";"4h 0m";""
"251";"USDJPY_M1";"Buy";"2015.03.19 01:00:00";"119.774";"0.10000";"2015.03.22 21:00:00";"119.808";"3.40";"10802.20";"IST";"End Of Friday";"0.00";"142.70";"3d 20h 0m";""
"252";"USDJPY_M1";"Buy";"2015.03.23 01:00:00";"119.947";"0.10000";"2015.03.23 14:00:00";"119.597";"-35.00";"10767.20";"IST";"SL";"-35.00";"21.80";"13h 0m";""
"253";"USDJPY_M1";"Buy";"2015.03.23 15:00:00";"119.709";"0.10000";"2015.03.24 10:00:00";"119.359";"-35.00";"10732.20";"IST";"SL";"-35.00";"18.60";"19h 0m";""
"254";"USDJPY_M1";"Sell";"2015.03.24 15:00:00";"119.686";"0.10000";"2015.03.29 21:00:00";"119.233";"45.30";"10777.50";"IST";"End Of Friday";"-31.70";"133.80";"5d 6h 0m";""
"255";"USDJPY_M1";"Sell";"2015.03.29 23:00:00";"119.232";"0.10000";"2015.03.30 07:00:00";"119.582";"-35.00";"10742.50";"IST";"SL";"-35.00";"9.30";"8h 0m";""
"256";"USDJPY_M1";"Buy";"2015.03.30 09:00:00";"119.715";"0.10000";"2015.04.03 12:00:00";"119.365";"-35.00";"10707.50";"IST";"SL";"-35.00";"64.90";"4d 3h 0m";""
"257";"USDJPY_M1";"Sell";"2015.04.03 14:00:00";"118.860";"0.10000";"2015.04.05 21:00:00";"118.852";"0.80";"10708.30";"IST";"End Of Friday";"-19.90";"0.80";"2d 7h 0m";""
"258";"USDJPY_M1";"Buy";"2015.04.05 21:00:00";"118.852";"0.10000";"2015.04.09 18:00:00";"120.652";"180.00";"10888.30";"IST";"PT";"-5.40";"180.00";"3d 21h 0m";""
"259";"USDJPY_M1";"Sell";"2015.04.10 00:00:00";"120.558";"0.10000";"2015.04.12 21:00:00";"120.355";"20.30";"10908.60";"IST";"End Of Friday";"-8.10";"48.20";"2d 21h 0m";""
"260";"USDJPY_M1";"Buy";"2015.04.13 01:00:00";"120.214";"0.10000";"2015.04.13 12:00:00";"119.864";"-35.00";"10873.60";"IST";"SL";"-35.00";"63.00";"11h 0m";""
"261";"USDJPY_M1";"Sell";"2015.04.13 14:00:00";"120.152";"0.10000";"2015.04.19 21:00:00";"119.021";"113.10";"10986.70";"IST";"End Of Friday";"-29.60";"156.40";"6d 7h 0m";""
"262";"USDJPY_M1";"Buy";"2015.04.20 00:00:00";"118.863";"0.10000";"2015.04.26 21:00:00";"118.861";"-0.20";"10986.50";"IST";"End Of Friday";"-33.40";"123.00";"6d 21h 0m";""
"263";"USDJPY_M1";"Buy";"2015.04.26 23:00:00";"118.896";"0.10000";"2015.04.30 04:00:00";"118.546";"-35.00";"10951.50";"IST";"SL";"-35.00";"53.70";"3d 5h 0m";""
"264";"USDJPY_M1";"Sell";"2015.04.30 05:00:00";"118.636";"0.10000";"2015.04.30 07:00:00";"118.986";"-35.00";"10916.50";"IST";"SL";"-35.00";"11.90";"2h 0m";""
"265";"USDJPY_M1";"Buy";"2015.04.30 09:00:00";"118.909";"0.10000";"2015.05.03 21:00:00";"120.221";"131.20";"11047.70";"IST";"End Of Friday";"-9.90";"137.70";"3d 12h 0m";""
"266";"USDJPY_M1";"Sell";"2015.05.03 22:00:00";"120.223";"0.10000";"2015.05.10 21:00:00";"119.652";"57.10";"11104.80";"IST";"End Of Friday";"-30.20";"114.70";"6d 23h 0m";""
"267";"USDJPY_M1";"Sell";"2015.05.10 22:00:00";"119.753";"0.10000";"2015.05.11 15:00:00";"120.103";"-35.00";"11069.80";"IST";"SL";"-35.00";"1.50";"17h 0m";""
"268";"USDJPY_M1";"Sell";"2015.05.11 23:00:00";"120.135";"0.10000";"2015.05.17 21:00:00";"119.289";"84.60";"11154.40";"IST";"End Of Friday";"-16.10";"122.90";"5d 22h 0m";""
"269";"USDJPY_M1";"Sell";"2015.05.17 22:00:00";"119.368";"0.10000";"2015.05.18 00:00:00";"119.718";"-35.00";"11119.40";"IST";"SL";"-35.00";"1.50";"2h 0m";""
"270";"USDJPY_M1";"Buy";"2015.05.18 03:00:00";"119.658";"0.10000";"2015.05.20 18:00:00";"121.458";"180.00";"11299.40";"IST";"PT";"-12.40";"180.00";"2d 15h 0m";""
"271";"USDJPY_M1";"Sell";"2015.05.20 21:00:00";"121.306";"0.10000";"2015.05.24 21:00:00";"121.503";"-19.70";"11279.70";"IST";"End Of Friday";"-28.50";"64.70";"4d 0h 0m";""
"272";"USDJPY_M1";"Sell";"2015.05.24 22:00:00";"121.569";"0.10000";"2015.05.26 06:00:00";"121.919";"-35.00";"11244.70";"IST";"SL";"-35.00";"10.30";"1d 8h 0m";""
"273";"USDJPY_M1";"Buy";"2015.05.26 09:00:00";"122.798";"0.10000";"2015.05.31 21:00:00";"124.067";"126.90";"11371.60";"IST";"End Of Friday";"-31.30";"166.20";"5d 12h 0m";""
"274";"USDJPY_M1";"Sell";"2015.06.01 04:00:00";"124.106";"0.10000";"2015.06.01 14:00:00";"124.456";"-35.00";"11336.60";"IST";"SL";"-35.00";"22.70";"10h 0m";""
"275";"USDJPY_M1";"Sell";"2015.06.01 15:00:00";"124.529";"0.10000";"2015.06.01 16:00:00";"124.879";"-35.00";"11301.60";"IST";"SL";"-35.00";"3.00";"1h 0m";""
"276";"USDJPY_M1";"Buy";"2015.06.01 17:00:00";"124.890";"0.10000";"2015.06.02 05:00:00";"124.540";"-35.00";"11266.60";"IST";"SL";"-35.00";"16.30";"12h 0m";""
"277";"USDJPY_M1";"Sell";"2015.06.02 06:00:00";"124.634";"0.10000";"2015.06.05 12:00:00";"124.984";"-35.00";"11231.60";"IST";"SL";"-35.00";"86.10";"3d 6h 0m";""
"278";"USDJPY_M1";"Sell";"2015.06.05 14:00:00";"125.683";"0.10000";"2015.06.07 21:00:00";"125.607";"7.60";"11239.20";"IST";"End Of Friday";"-3.20";"29.40";"2d 7h 0m";""
"279";"USDJPY_M1";"Sell";"2015.06.07 21:00:00";"125.587";"0.10000";"2015.06.10 04:00:00";"123.787";"180.00";"11419.20";"IST";"PT";"-11.10";"180.00";"2d 7h 0m";""
"280";"USDJPY_M1";"Sell";"2015.06.10 07:00:00";"123.010";"0.10000";"2015.06.10 10:00:00";"123.360";"-35.00";"11384.20";"IST";"SL";"-35.00";"53.40";"3h 0m";""
"281";"USDJPY_M1";"Buy";"2015.06.10 13:00:00";"122.728";"0.10000";"2015.06.14 21:00:00";"123.188";"46.00";"11430.20";"IST";"End Of Friday";"-18.60";"140.50";"4d 8h 0m";""
"282";"USDJPY_M1";"Buy";"2015.06.15 02:00:00";"123.507";"0.10000";"2015.06.18 02:00:00";"123.157";"-35.00";"11395.20";"IST";"SL";"-35.00";"93.10";"3d 0h 0m";""
"283";"USDJPY_M1";"Sell";"2015.06.18 03:00:00";"123.074";"0.10000";"2015.06.21 21:00:00";"122.967";"10.70";"11405.90";"IST";"End Of Friday";"-16.30";"57.60";"3d 18h 0m";""
"284";"USDJPY_M1";"Buy";"2015.06.21 22:00:00";"122.950";"0.10000";"2015.06.22 01:00:00";"122.600";"-35.00";"11370.90";"IST";"SL";"-35.00";"0.00";"3h 0m";""
"285";"USDJPY_M1";"Buy";"2015.06.22 02:00:00";"122.751";"0.10000";"2015.06.28 21:00:00";"122.680";"-7.10";"11363.80";"IST";"End Of Friday";"-9.50";"162.40";"6d 19h 0m";""
"286";"USDJPY_M1";"Sell";"2015.06.28 21:00:00";"122.680";"0.10000";"2015.06.29 00:00:00";"123.030";"-35.00";"11328.80";"IST";"SL";"-35.00";"55.30";"3h 0m";""
"287";"USDJPY_M1";"Sell";"2015.06.29 01:00:00";"122.954";"0.10000";"2015.07.01 23:00:00";"123.304";"-35.00";"11293.80";"IST";"SL";"-35.00";"99.20";"2d 22h 0m";""
"288";"USDJPY_M1";"Sell";"2015.07.02 00:00:00";"123.329";"0.10000";"2015.07.02 12:00:00";"123.679";"-35.00";"11258.80";"IST";"SL";"-35.00";"1.40";"12h 0m";""
"289";"USDJPY_M1";"Sell";"2015.07.02 14:00:00";"123.068";"0.10000";"2015.07.05 21:00:00";"121.889";"117.90";"11376.70";"IST";"End Of Friday";"-13.50";"117.90";"3d 7h 0m";""
"290";"USDJPY_M1";"Buy";"2015.07.05 23:00:00";"122.390";"0.10000";"2015.07.07 15:00:00";"122.040";"-35.00";"11341.70";"IST";"SL";"-35.00";"53.80";"1d 16h 0m";""
"291";"USDJPY_M1";"Buy";"2015.07.07 20:00:00";"122.626";"0.10000";"2015.07.08 01:00:00";"122.276";"-35.00";"11306.70";"IST";"SL";"-35.00";"2.40";"5h 0m";""
"292";"USDJPY_M1";"Sell";"2015.07.08 03:00:00";"122.210";"0.10000";"2015.07.10 13:00:00";"122.560";"-35.00";"11271.70";"IST";"SL";"-35.00";"177.60";"2d 10h 0m";""
"293";"USDJPY_M1";"Sell";"2015.07.10 20:00:00";"122.830";"0.10000";"2015.07.12 21:00:00";"122.183";"64.70";"11336.40";"IST";"End Of Friday";"-2.00";"64.70";"2d 1h 0m";""
"294";"USDJPY_M1";"Sell";"2015.07.12 21:00:00";"122.163";"0.10000";"2015.07.12 21:00:00";"122.513";"-35.00";"11301.40";"IST";"SL";"-35.00";"0.00";"0s";""
"295";"USDJPY_M1";"Sell";"2015.07.12 22:00:00";"122.536";"0.10000";"2015.07.13 06:00:00";"122.886";"-35.00";"11266.40";"IST";"SL";"-35.00";"10.30";"8h 0m";""
"296";"USDJPY_M1";"Sell";"2015.07.13 07:00:00";"123.008";"0.10000";"2015.07.13 07:00:00";"123.358";"-35.00";"11231.40";"IST";"SL";"-35.00";"11.80";"0s";""
"297";"USDJPY_M1";"Sell";"2015.07.13 15:00:00";"123.456";"0.10000";"2015.07.15 12:00:00";"123.806";"-35.00";"11196.40";"IST";"SL";"-35.00";"51.50";"1d 21h 0m";""
"298";"USDJPY_M1";"Buy";"2015.07.15 15:00:00";"123.940";"0.10000";"2015.07.19 21:00:00";"124.014";"7.40";"11203.80";"IST";"End Of Friday";"-28.60";"29.00";"4d 6h 0m";""
"299";"USDJPY_M1";"Buy";"2015.07.20 00:00:00";"124.163";"0.10000";"2015.07.21 15:00:00";"123.813";"-35.00";"11168.80";"IST";"SL";"-35.00";"31.40";"1d 15h 0m";""
"300";"USDJPY_M1";"Sell";"2015.07.21 16:00:00";"123.935";"0.10000";"2015.07.26 21:00:00";"123.738";"19.70";"11188.50";"IST";"End Of Friday";"-27.10";"34.30";"5d 5h 0m";""
"301";"USDJPY_M1";"Buy";"2015.07.27 11:00:00";"123.337";"0.10000";"2015.08.02 21:00:00";"123.882";"54.50";"11243.00";"IST";"End Of Friday";"-32.80";"124.50";"6d 10h 0m";""
"302";"USDJPY_M1";"Buy";"2015.08.02 21:00:00";"123.902";"0.10000";"2015.08.09 21:00:00";"124.151";"24.90";"11267.90";"IST";"End Of Friday";"-10.20";"116.80";"7d 0h 0m";""
"303";"USDJPY_M1";"Buy";"2015.08.09 23:00:00";"124.296";"0.10000";"2015.08.12 12:00:00";"123.946";"-35.00";"11232.90";"IST";"SL";"-35.00";"98.40";"2d 13h 0m";""
"304";"USDJPY_M1";"Buy";"2015.08.12 19:00:00";"124.177";"0.10000";"2015.08.16 21:00:00";"124.204";"2.70";"11235.60";"IST";"End Of Friday";"-12.30";"44.80";"4d 2h 0m";""
"305";"USDJPY_M1";"Buy";"2015.08.17 01:00:00";"124.412";"0.10000";"2015.08.19 15:00:00";"124.062";"-35.00";"11200.60";"IST";"SL";"-35.00";"16.20";"2d 14h 0m";""
"306";"USDJPY_M1";"Sell";"2015.08.19 17:00:00";"124.067";"0.10000";"2015.08.21 15:00:00";"122.267";"180.00";"11380.60";"IST";"PT";"-10.90";"180.00";"1d 22h 0m";""
"307";"USDJPY_M1";"Buy";"2015.08.21 20:00:00";"122.116";"0.10000";"2015.08.23 21:00:00";"121.841";"-27.50";"11353.10";"IST";"End Of Friday";"-27.50";"8.50";"2d 1h 0m";""
"308";"USDJPY_M1";"Buy";"2015.08.23 21:00:00";"121.861";"0.10000";"2015.08.23 23:00:00";"121.511";"-35.00";"11318.10";"IST";"SL";"-35.00";"16.10";"2h 0m";""
"309";"USDJPY_M1";"Buy";"2015.08.24 00:00:00";"121.753";"0.10000";"2015.08.24 01:00:00";"121.403";"-35.00";"11283.10";"IST";"SL";"-35.00";"17.60";"1h 0m";""
"310";"USDJPY_M1";"Buy";"2015.08.24 02:00:00";"121.357";"0.10000";"2015.08.24 02:00:00";"121.007";"-35.00";"11248.10";"IST";"SL";"-35.00";"0.00";"0s";""
"311";"USDJPY_M1";"Buy";"2015.08.24 03:00:00";"120.911";"0.10000";"2015.08.24 07:00:00";"120.561";"-35.00";"11213.10";"IST";"SL";"-35.00";"36.50";"4h 0m";""
"312";"USDJPY_M1";"Buy";"2015.08.24 08:00:00";"120.426";"0.10000";"2015.08.24 10:00:00";"120.076";"-35.00";"11178.10";"IST";"SL";"-35.00";"28.80";"2h 0m";""
"313";"USDJPY_M1";"Buy";"2015.08.24 11:00:00";"120.142";"0.10000";"2015.08.24 11:00:00";"119.792";"-35.00";"11143.10";"IST";"SL";"-35.00";"5.60";"0s";""
"314";"USDJPY_M1";"Sell";"2015.08.24 16:00:00";"118.657";"0.10000";"2015.08.24 16:00:00";"119.007";"-35.00";"11108.10";"IST";"SL";"-35.00";"19.80";"0s";""
"315";"USDJPY_M1";"Buy";"2015.08.24 19:00:00";"118.381";"0.10000";"2015.08.25 10:00:00";"120.181";"180.00";"11288.10";"IST";"PT";"-13.30";"180.00";"15h 0m";""
"316";"USDJPY_M1";"Buy";"2015.08.25 11:00:00";"120.160";"0.10000";"2015.08.25 12:00:00";"119.810";"-35.00";"11253.10";"IST";"SL";"-35.00";"5.80";"1h 0m";""
"317";"USDJPY_M1";"Buy";"2015.08.26 11:00:00";"119.550";"0.10000";"2015.08.26 14:00:00";"119.200";"-35.00";"11218.10";"IST";"SL";"-35.00";"36.40";"3h 0m";""
"318";"USDJPY_M1";"Sell";"2015.08.26 17:00:00";"119.351";"0.10000";"2015.08.26 17:00:00";"119.701";"-35.00";"11183.10";"IST";"SL";"-35.00";"3.60";"0s";""
"319";"USDJPY_M1";"Sell";"2015.08.27 02:00:00";"120.193";"0.10000";"2015.08.27 07:00:00";"120.543";"-35.00";"11148.10";"IST";"SL";"-35.00";"38.30";"5h 0m";""
"320";"USDJPY_M1";"Sell";"2015.08.27 08:00:00";"120.439";"0.10000";"2015.08.27 14:00:00";"120.789";"-35.00";"11113.10";"IST";"SL";"-35.00";"28.00";"6h 0m";""
"321";"USDJPY_M1";"Sell";"2015.08.27 21:00:00";"121.010";"0.10000";"2015.08.28 15:00:00";"121.360";"-35.00";"11078.10";"IST";"SL";"-35.00";"34.00";"18h 0m";""
"322";"USDJPY_M1";"Sell";"2015.08.31 03:00:00";"121.110";"0.10000";"2015.09.01 20:00:00";"119.310";"180.00";"11258.10";"IST";"PT";"-32.60";"180.00";"1d 17h 0m";""
"323";"USDJPY_M1";"Buy";"2015.09.01 21:00:00";"119.390";"0.10000";"2015.09.04 08:00:00";"119.040";"-35.00";"11223.10";"IST";"SL";"-35.00";"130.70";"2d 11h 0m";""
"324";"USDJPY_M1";"Buy";"2015.09.04 09:00:00";"119.094";"0.10000";"2015.09.04 12:00:00";"118.744";"-35.00";"11188.10";"IST";"SL";"-35.00";"53.40";"3h 0m";""
"325";"USDJPY_M1";"Buy";"2015.09.04 13:00:00";"119.093";"0.10000";"2015.09.06 21:00:00";"118.913";"-18.00";"11170.10";"IST";"End Of Friday";"-32.00";"33.10";"2d 8h 0m";""
"326";"USDJPY_M1";"Buy";"2015.09.06 21:00:00";"118.933";"0.10000";"2015.09.09 07:00:00";"120.733";"180.00";"11350.10";"IST";"PT";"-13.50";"180.00";"2d 10h 0m";""
"327";"USDJPY_M1";"Sell";"2015.09.09 11:00:00";"120.606";"0.10000";"2015.09.09 11:00:00";"120.956";"-35.00";"11315.10";"IST";"SL";"-35.00";"0.20";"0s";""
"328";"USDJPY_M1";"Sell";"2015.09.09 12:00:00";"120.940";"0.10000";"2015.09.10 04:00:00";"121.290";"-35.00";"11280.10";"IST";"SL";"-35.00";"94.30";"16h 0m";""
"329";"USDJPY_M1";"Buy";"2015.09.10 07:00:00";"120.721";"0.10000";"2015.09.11 07:00:00";"120.371";"-35.00";"11245.10";"IST";"SL";"-35.00";"60.40";"1d 0h 0m";""
"330";"USDJPY_M1";"Buy";"2015.09.11 19:00:00";"120.612";"0.10000";"2015.09.13 21:00:00";"120.510";"-10.20";"11234.90";"IST";"End Of Friday";"-10.20";"4.30";"2d 2h 0m";""
"331";"USDJPY_M1";"Buy";"2015.09.14 03:00:00";"120.461";"0.10000";"2015.09.14 08:00:00";"120.111";"-35.00";"11199.90";"IST";"SL";"-35.00";"2.80";"5h 0m";""
"332";"USDJPY_M1";"Buy";"2015.09.14 13:00:00";"120.305";"0.10000";"2015.09.14 15:00:00";"119.955";"-35.00";"11164.90";"IST";"SL";"-35.00";"0.00";"2h 0m";""
"333";"USDJPY_M1";"Buy";"2015.09.14 20:00:00";"120.175";"0.10000";"2015.09.15 05:00:00";"119.825";"-35.00";"11129.90";"IST";"SL";"-35.00";"47.60";"9h 0m";""
"334";"USDJPY_M1";"Sell";"2015.09.15 06:00:00";"119.834";"0.10000";"2015.09.15 14:00:00";"120.184";"-35.00";"11094.90";"IST";"SL";"-35.00";"41.40";"8h 0m";""
"335";"USDJPY_M1";"Buy";"2015.09.15 15:00:00";"120.169";"0.10000";"2015.09.17 19:00:00";"119.819";"-35.00";"11059.90";"IST";"SL";"-35.00";"82.00";"2d 4h 0m";""
"336";"USDJPY_M1";"Sell";"2015.09.17 20:00:00";"119.884";"0.10000";"2015.09.17 21:00:00";"120.234";"-35.00";"11024.90";"IST";"SL";"-35.00";"4.10";"1h 0m";""
"337";"USDJPY_M1";"Sell";"2015.09.17 22:00:00";"120.188";"0.10000";"2015.09.20 21:00:00";"120.131";"5.70";"11030.60";"IST";"End Of Friday";"-24.30";"111.40";"2d 23h 0m";""
"338";"USDJPY_M1";"Buy";"2015.09.20 21:00:00";"120.131";"0.10000";"2015.09.21 00:00:00";"119.781";"-35.00";"10995.60";"IST";"SL";"-35.00";"1.40";"3h 0m";""
"339";"USDJPY_M1";"Sell";"2015.09.21 16:00:00";"120.464";"0.10000";"2015.09.25 08:00:00";"120.814";"-35.00";"10960.60";"IST";"SL";"-35.00";"122.10";"3d 16h 0m";""
"340";"USDJPY_M1";"Sell";"2015.09.25 13:00:00";"120.976";"0.10000";"2015.09.27 21:00:00";"120.529";"44.70";"11005.30";"IST";"End Of Friday";"0.00";"50.70";"2d 8h 0m";""
"341";"USDJPY_M1";"Sell";"2015.09.27 21:00:00";"120.509";"0.10000";"2015.10.02 14:00:00";"118.709";"180.00";"11185.30";"IST";"PT";"-10.20";"180.00";"4d 17h 0m";""
"342";"USDJPY_M1";"Sell";"2015.10.02 15:00:00";"119.215";"0.10000";"2015.10.02 16:00:00";"119.565";"-35.00";"11150.30";"IST";"SL";"-35.00";"3.90";"1h 0m";""
"343";"USDJPY_M1";"Buy";"2015.10.02 19:00:00";"119.889";"0.10000";"2015.10.04 21:00:00";"119.961";"7.20";"11157.50";"IST";"End Of Friday";"-1.80";"24.20";"2d 2h 0m";""
"344";"USDJPY_M1";"Buy";"2015.10.05 05:00:00";"120.023";"0.10000";"2015.10.08 07:00:00";"119.673";"-35.00";"11122.50";"IST";"SL";"-35.00";"54.50";"3d 2h 0m";""
"345";"USDJPY_M1";"Buy";"2015.10.08 17:00:00";"119.934";"0.10000";"2015.10.11 21:00:00";"120.170";"23.60";"11146.10";"IST";"End Of Friday";"-25.40";"41.20";"3d 4h 0m";""
"346";"USDJPY_M1";"Sell";"2015.10.11 21:00:00";"120.170";"0.10000";"2015.10.15 07:00:00";"118.370";"180.00";"11326.10";"IST";"PT";"-10.70";"180.00";"3d 10h 0m";""
"347";"USDJPY_M1";"Buy";"2015.10.15 15:00:00";"118.542";"0.10000";"2015.10.18 21:00:00";"119.364";"82.20";"11408.30";"IST";"End Of Friday";"-31.20";"111.90";"3d 6h 0m";""
"348";"USDJPY_M1";"Sell";"2015.10.18 23:00:00";"119.382";"0.10000";"2015.10.20 07:00:00";"119.732";"-35.00";"11373.30";"IST";"SL";"-35.00";"22.30";"1d 8h 0m";""
"349";"USDJPY_M1";"Sell";"2015.10.20 08:00:00";"119.652";"0.10000";"2015.10.21 04:00:00";"120.002";"-35.00";"11338.30";"IST";"SL";"-35.00";"16.40";"20h 0m";""
"350";"USDJPY_M1";"Sell";"2015.10.21 05:00:00";"119.965";"0.10000";"2015.10.22 13:00:00";"120.315";"-35.00";"11303.30";"IST";"SL";"-35.00";"33.00";"1d 8h 0m";""
"351";"USDJPY_M1";"Buy";"2015.10.22 14:00:00";"120.447";"0.10000";"2015.10.25 21:00:00";"121.434";"98.70";"11402.00";"IST";"End Of Friday";"-22.00";"103.30";"3d 7h 0m";""
"352";"USDJPY_M1";"Sell";"2015.10.26 00:00:00";"121.318";"0.10000";"2015.11.01 22:00:00";"120.375";"94.30";"11496.30";"IST";"End Of Friday";"-18.60";"127.10";"6d 22h 0m";""
"353";"USDJPY_M1";"Buy";"2015.11.01 22:00:00";"120.375";"0.10000";"2015.11.06 13:00:00";"122.175";"180.00";"11676.30";"IST";"PT";"-11.80";"180.00";"4d 15h 0m";""
"354";"USDJPY_M1";"Buy";"2015.11.06 16:00:00";"123.192";"0.10000";"2015.11.06 21:00:00";"123.201";"0.90";"11677.20";"IST";"End Of Friday (Time)";"-4.10";"7.50";"5h 0m";""
"355";"USDJPY_M1";"Sell";"2015.11.08 23:00:00";"123.314";"0.10000";"2015.11.13 21:00:00";"122.673";"64.10";"11741.30";"IST";"End Of Friday (Time)";"-30.80";"85.10";"4d 22h 0m";""
"356";"USDJPY_M1";"Buy";"2015.11.16 03:00:00";"122.493";"0.10000";"2015.11.20 21:00:00";"122.900";"40.70";"11782.00";"IST";"End Of Friday (Time)";"-10.80";"125.70";"4d 18h 0m";""
"357";"USDJPY_M1";"Buy";"2015.11.22 22:00:00";"122.831";"0.10000";"2015.11.24 08:00:00";"122.481";"-35.00";"11747.00";"IST";"SL";"-35.00";"42.80";"1d 10h 0m";""
"358";"USDJPY_M1";"Buy";"2015.11.24 13:00:00";"122.542";"0.10000";"2015.11.27 21:00:00";"122.845";"30.30";"11777.30";"IST";"End Of Friday (Time)";"-28.40";"39.20";"3d 8h 0m";""
"359";"USDJPY_M1";"Sell";"2015.11.30 00:00:00";"122.832";"0.10000";"2015.11.30 15:00:00";"123.182";"-35.00";"11742.30";"IST";"SL";"-35.00";"12.60";"15h 0m";""
"360";"USDJPY_M1";"Sell";"2015.11.30 16:00:00";"123.280";"0.10000";"2015.12.02 17:00:00";"123.630";"-35.00";"11707.30";"IST";"SL";"-35.00";"61.70";"2d 1h 0m";""
"361";"USDJPY_M1";"Sell";"2015.12.02 21:00:00";"123.226";"0.10000";"2015.12.03 09:00:00";"123.576";"-35.00";"11672.30";"IST";"SL";"-35.00";"1.00";"12h 0m";""
"362";"USDJPY_M1";"Sell";"2015.12.03 10:00:00";"123.474";"0.10000";"2015.12.04 21:00:00";"123.197";"27.70";"11700.00";"IST";"End Of Friday (Time)";"-3.80";"115.70";"1d 11h 0m";""
"363";"USDJPY_M1";"Sell";"2015.12.07 03:00:00";"123.302";"0.10000";"2015.12.09 17:00:00";"121.502";"180.00";"11880.00";"IST";"PT";"-19.40";"180.00";"2d 14h 0m";""
"364";"USDJPY_M1";"Buy";"2015.12.09 23:00:00";"121.650";"0.10000";"2015.12.10 01:00:00";"121.300";"-35.00";"11845.00";"IST";"SL";"-35.00";"9.60";"2h 0m";""
"365";"USDJPY_M1";"Buy";"2015.12.10 02:00:00";"121.564";"0.10000";"2015.12.11 14:00:00";"121.214";"-35.00";"11810.00";"IST";"SL";"-35.00";"66.50";"1d 12h 0m";""
"366";"USDJPY_M1";"Sell";"2015.12.11 17:00:00";"120.953";"0.10000";"2015.12.11 21:00:00";"120.894";"5.90";"11815.90";"IST";"End Of Friday (Time)";"0.00";"35.20";"4h 0m";""
"367";"USDJPY_M1";"Buy";"2015.12.13 23:00:00";"121.095";"0.10000";"2015.12.13 23:00:00";"120.745";"-35.00";"11780.90";"IST";"SL";"-35.00";"0.00";"0s";""
"368";"USDJPY_M1";"Buy";"2015.12.14 00:00:00";"120.909";"0.10000";"2015.12.14 16:00:00";"120.559";"-35.00";"11745.90";"IST";"SL";"-35.00";"44.40";"16h 0m";""
"369";"USDJPY_M1";"Buy";"2015.12.14 20:00:00";"120.852";"0.10000";"2015.12.17 14:00:00";"122.652";"180.00";"11925.90";"IST";"PT";"-27.80";"180.00";"2d 18h 0m";""
"370";"USDJPY_M1";"Sell";"2015.12.17 15:00:00";"122.700";"0.10000";"2015.12.18 03:00:00";"123.050";"-35.00";"11890.90";"IST";"SL";"-35.00";"33.00";"12h 0m";""
"371";"USDJPY_M1";"Buy";"2015.12.18 06:00:00";"121.908";"0.10000";"2015.12.18 08:00:00";"121.558";"-35.00";"11855.90";"IST";"SL";"-35.00";"20.30";"2h 0m";""
"372";"USDJPY_M1";"Sell";"2015.12.18 11:00:00";"121.598";"0.10000";"2015.12.18 21:00:00";"121.270";"32.80";"11888.70";"IST";"End Of Friday (Time)";"-17.40";"52.00";"10h 0m";""
"373";"USDJPY_M1";"Buy";"2015.12.20 23:00:00";"121.329";"0.10000";"2015.12.21 16:00:00";"120.979";"-35.00";"11853.70";"IST";"SL";"-35.00";"17.50";"17h 0m";""
"374";"USDJPY_M1";"Buy";"2015.12.21 23:00:00";"121.254";"0.10000";"2015.12.22 09:00:00";"120.904";"-35.00";"11818.70";"IST";"SL";"-35.00";"5.60";"10h 0m";""
"375";"USDJPY_M1";"Buy";"2015.12.22 16:00:00";"120.915";"0.10000";"2015.12.24 05:00:00";"120.565";"-35.00";"11783.70";"IST";"SL";"-35.00";"21.70";"1d 13h 0m";""
"376";"USDJPY_M1";"Buy";"2015.12.24 14:00:00";"120.372";"0.10000";"2015.12.27 22:00:00";"120.182";"-19.00";"11764.70";"IST";"End Of Friday";"-34.00";"5.60";"3d 8h 0m";""
"377";"USDJPY_M1";"Buy";"2015.12.27 23:00:00";"120.274";"0.10000";"2016.01.03 22:00:00";"120.188";"-8.60";"11756.10";"IST";"End Of Friday";"-26.90";"37.90";"6d 23h 0m";""
"378";"USDJPY_M1";"Buy";"2016.01.03 22:00:00";"120.208";"0.10000";"2016.01.04 02:00:00";"119.858";"-35.00";"11721.10";"IST";"SL";"-35.00";"25.60";"4h 0m";""
"379";"USDJPY_M1";"Buy";"2016.01.04 03:00:00";"119.837";"0.10000";"2016.01.04 04:00:00";"119.487";"-35.00";"11686.10";"IST";"SL";"-35.00";"0.00";"1h 0m";""
"380";"USDJPY_M1";"Buy";"2016.01.04 13:00:00";"119.087";"0.10000";"2016.01.06 01:00:00";"118.737";"-35.00";"11651.10";"IST";"SL";"-35.00";"60.70";"1d 12h 0m";""
"381";"USDJPY_M1";"Buy";"2016.01.06 02:00:00";"118.585";"0.10000";"2016.01.07 01:00:00";"118.235";"-35.00";"11616.10";"IST";"SL";"-35.00";"23.00";"23h 0m";""
"382";"USDJPY_M1";"Sell";"2016.01.07 04:00:00";"118.209";"0.10000";"2016.01.08 01:00:00";"118.559";"-35.00";"11581.10";"IST";"SL";"-35.00";"86.10";"21h 0m";""
"383";"USDJPY_M1";"Buy";"2016.01.08 03:00:00";"118.228";"0.10000";"2016.01.08 15:00:00";"117.878";"-35.00";"11546.10";"IST";"SL";"-35.00";"60.20";"12h 0m";""
"384";"USDJPY_M1";"Sell";"2016.01.08 16:00:00";"117.684";"0.10000";"2016.01.08 21:00:00";"117.516";"16.80";"11562.90";"IST";"End Of Friday (Time)";"-28.40";"21.50";"5h 0m";""
"385";"USDJPY_M1";"Buy";"2016.01.11 04:00:00";"117.372";"0.10000";"2016.01.15 13:00:00";"117.022";"-35.00";"11527.90";"IST";"SL";"-35.00";"100.70";"4d 9h 0m";""
"386";"USDJPY_M1";"Buy";"2016.01.17 22:00:00";"116.699";"0.10000";"2016.01.20 08:00:00";"116.349";"-35.00";"11492.90";"IST";"SL";"-35.00";"141.50";"2d 10h 0m";""
"387";"USDJPY_M1";"Buy";"2016.01.20 12:00:00";"116.524";"0.10000";"2016.01.22 14:00:00";"118.324";"180.00";"11672.90";"IST";"PT";"-32.20";"180.00";"2d 2h 0m";""
"388";"USDJPY_M1";"Sell";"2016.01.22 16:00:00";"118.512";"0.10000";"2016.01.22 20:00:00";"118.862";"-35.00";"11637.90";"IST";"SL";"-35.00";"14.60";"4h 0m";""
"389";"USDJPY_M1";"Sell";"2016.01.25 00:00:00";"118.559";"0.10000";"2016.01.27 16:00:00";"118.909";"-35.00";"11602.90";"IST";"SL";"-35.00";"88.30";"2d 16h 0m";""
"390";"USDJPY_M1";"Sell";"2016.01.27 22:00:00";"118.658";"0.10000";"2016.01.28 14:00:00";"119.008";"-35.00";"11567.90";"IST";"SL";"-35.00";"22.40";"16h 0m";""
"391";"USDJPY_M1";"Sell";"2016.01.28 17:00:00";"118.613";"0.10000";"2016.01.28 23:00:00";"118.963";"-35.00";"11532.90";"IST";"SL";"-35.00";"0.00";"6h 0m";""
"392";"USDJPY_M1";"Sell";"2016.01.29 03:00:00";"118.593";"0.10000";"2016.01.29 03:00:00";"118.943";"-35.00";"11497.90";"IST";"SL";"-35.00";"7.50";"0s";""
"393";"USDJPY_M1";"Buy";"2016.01.29 06:00:00";"120.582";"0.10000";"2016.01.29 21:00:00";"121.067";"48.50";"11546.40";"IST";"End Of Friday (Time)";"-5.90";"110.40";"15h 0m";""
"394";"USDJPY_M1";"Sell";"2016.01.31 22:00:00";"121.330";"0.10000";"2016.02.03 01:00:00";"119.530";"180.00";"11726.40";"IST";"PT";"-17.70";"180.00";"2d 3h 0m";""
"395";"USDJPY_M1";"Buy";"2016.02.03 02:00:00";"119.639";"0.10000";"2016.02.03 10:00:00";"119.289";"-35.00";"11691.40";"IST";"SL";"-35.00";"40.40";"8h 0m";""
"396";"USDJPY_M1";"Buy";"2016.02.03 11:00:00";"119.277";"0.10000";"2016.02.03 14:00:00";"118.927";"-35.00";"11656.40";"IST";"SL";"-35.00";"34.60";"3h 0m";""
"397";"USDJPY_M1";"Buy";"2016.02.03 22:00:00";"117.904";"0.10000";"2016.02.04 09:00:00";"117.554";"-35.00";"11621.40";"IST";"SL";"-35.00";"33.60";"11h 0m";""
"398";"USDJPY_M1";"Buy";"2016.02.04 10:00:00";"117.725";"0.10000";"2016.02.04 12:00:00";"117.375";"-35.00";"11586.40";"IST";"SL";"-35.00";"5.90";"2h 0m";""
"399";"USDJPY_M1";"Buy";"2016.02.04 22:00:00";"116.796";"0.10000";"2016.02.05 13:00:00";"116.446";"-35.00";"11551.40";"IST";"SL";"-35.00";"18.60";"15h 0m";""
"400";"USDJPY_M1";"Buy";"2016.02.05 16:00:00";"117.019";"0.10000";"2016.02.05 21:00:00";"116.971";"-4.80";"11546.60";"IST";"End Of Friday (Time)";"-18.30";"6.30";"5h 0m";""
"401";"USDJPY_M1";"Sell";"2016.02.08 10:00:00";"116.742";"0.10000";"2016.02.09 01:00:00";"114.942";"180.00";"11726.60";"IST";"PT";"-2.90";"180.00";"15h 0m";""
"402";"USDJPY_M1";"Buy";"2016.02.09 02:00:00";"115.240";"0.10000";"2016.02.09 02:00:00";"114.890";"-35.00";"11691.60";"IST";"SL";"-35.00";"0.30";"0s";""
"403";"USDJPY_M1";"Buy";"2016.02.09 08:00:00";"115.321";"0.10000";"2016.02.09 11:00:00";"114.971";"-35.00";"11656.60";"IST";"SL";"-35.00";"22.00";"3h 0m";""
"404";"USDJPY_M1";"Buy";"2016.02.09 12:00:00";"115.074";"0.10000";"2016.02.09 12:00:00";"114.724";"-35.00";"11621.60";"IST";"SL";"-35.00";"1.00";"0s";""
"405";"USDJPY_M1";"Buy";"2016.02.09 13:00:00";"114.842";"0.10000";"2016.02.09 13:00:00";"114.492";"-35.00";"11586.60";"IST";"SL";"-35.00";"13.10";"0s";""
"406";"USDJPY_M1";"Buy";"2016.02.09 14:00:00";"114.397";"0.10000";"2016.02.10 16:00:00";"114.047";"-35.00";"11551.60";"IST";"SL";"-35.00";"98.70";"1d 2h 0m";""
"407";"USDJPY_M1";"Sell";"2016.02.10 18:00:00";"114.144";"0.10000";"2016.02.11 06:00:00";"112.344";"180.00";"11731.60";"IST";"PT";"0.00";"180.00";"12h 0m";""
"408";"USDJPY_M1";"Buy";"2016.02.11 08:00:00";"112.748";"0.10000";"2016.02.11 08:00:00";"112.398";"-35.00";"11696.60";"IST";"SL";"-35.00";"0.00";"0s";""
"409";"USDJPY_M1";"Buy";"2016.02.11 09:00:00";"111.589";"0.10000";"2016.02.11 09:00:00";"111.239";"-35.00";"11661.60";"IST";"SL";"-35.00";"0.00";"0s";""
"410";"USDJPY_M1";"Buy";"2016.02.11 10:00:00";"111.353";"0.10000";"2016.02.11 12:00:00";"113.153";"180.00";"11841.60";"IST";"PT";"-24.50";"180.00";"2h 0m";""
"411";"USDJPY_M1";"Buy";"2016.02.11 13:00:00";"112.213";"0.10000";"2016.02.11 15:00:00";"111.863";"-35.00";"11806.60";"IST";"SL";"-35.00";"47.50";"2h 0m";""
"412";"USDJPY_M1";"Buy";"2016.02.11 16:00:00";"111.896";"0.10000";"2016.02.12 21:00:00";"113.292";"139.60";"11946.20";"IST";"End Of Friday (Time)";"-32.30";"164.20";"1d 5h 0m";""
"413";"USDJPY_M1";"Sell";"2016.02.15 03:00:00";"113.806";"0.10000";"2016.02.15 12:00:00";"114.156";"-35.00";"11911.20";"IST";"SL";"-35.00";"18.60";"9h 0m";""
"414";"USDJPY_M1";"Sell";"2016.02.15 13:00:00";"114.138";"0.10000";"2016.02.15 15:00:00";"114.488";"-35.00";"11876.20";"IST";"SL";"-35.00";"6.80";"2h 0m";""
"415";"USDJPY_M1";"Sell";"2016.02.15 21:00:00";"114.570";"0.10000";"2016.02.19 01:00:00";"112.770";"180.00";"12056.20";"IST";"PT";"-32.60";"180.00";"3d 4h 0m";""
"416";"USDJPY_M1";"Buy";"2016.02.19 06:00:00";"113.084";"0.10000";"2016.02.19 16:00:00";"112.734";"-35.00";"12021.20";"IST";"SL";"-35.00";"13.10";"10h 0m";""
"417";"USDJPY_M1";"Buy";"2016.02.19 17:00:00";"112.450";"0.10000";"2016.02.19 21:00:00";"112.651";"20.10";"12041.30";"IST";"End Of Friday (Time)";"-2.80";"24.00";"4h 0m";""
"418";"USDJPY_M1";"Buy";"2016.02.21 22:00:00";"112.577";"0.10000";"2016.02.23 01:00:00";"112.227";"-35.00";"12006.30";"IST";"SL";"-35.00";"81.10";"1d 3h 0m";""
"419";"USDJPY_M1";"Sell";"2016.02.23 03:00:00";"112.200";"0.10000";"2016.02.23 04:00:00";"112.550";"-35.00";"11971.30";"IST";"SL";"-35.00";"20.70";"1h 0m";""
"420";"USDJPY_M1";"Buy";"2016.02.23 07:00:00";"112.279";"0.10000";"2016.02.23 08:00:00";"111.929";"-35.00";"11936.30";"IST";"SL";"-35.00";"5.40";"1h 0m";""
"421";"USDJPY_M1";"Buy";"2016.02.23 14:00:00";"112.339";"0.10000";"2016.02.23 15:00:00";"111.989";"-35.00";"11901.30";"IST";"SL";"-35.00";"7.50";"1h 0m";""
"422";"USDJPY_M1";"Buy";"2016.02.23 16:00:00";"112.085";"0.10000";"2016.02.24 04:00:00";"111.735";"-35.00";"11866.30";"IST";"SL";"-35.00";"16.20";"12h 0m";""
"423";"USDJPY_M1";"Buy";"2016.02.24 09:00:00";"112.113";"0.10000";"2016.02.24 10:00:00";"111.763";"-35.00";"11831.30";"IST";"SL";"-35.00";"0.00";"1h 0m";""
"424";"USDJPY_M1";"Buy";"2016.02.24 15:00:00";"111.483";"0.10000";"2016.02.24 15:00:00";"111.133";"-35.00";"11796.30";"IST";"SL";"-35.00";"2.00";"0s";""
"425";"USDJPY_M1";"Buy";"2016.02.24 20:00:00";"111.667";"0.10000";"2016.02.26 14:00:00";"113.467";"180.00";"11976.30";"IST";"PT";"-2.00";"180.00";"1d 18h 0m";""
"426";"USDJPY_M1";"Sell";"2016.02.28 23:00:00";"113.688";"0.10000";"2016.03.01 17:00:00";"114.038";"-35.00";"11941.30";"IST";"SL";"-35.00";"151.00";"1d 18h 0m";""
"427";"USDJPY_M1";"Buy";"2016.03.01 18:00:00";"114.025";"0.10000";"2016.03.02 18:00:00";"113.675";"-35.00";"11906.30";"IST";"SL";"-35.00";"53.00";"1d 0h 0m";""
"428";"USDJPY_M1";"Sell";"2016.03.02 19:00:00";"113.393";"0.10000";"2016.03.03 00:00:00";"113.743";"-35.00";"11871.30";"IST";"SL";"-35.00";"15.80";"5h 0m";""
"429";"USDJPY_M1";"Buy";"2016.03.03 02:00:00";"113.853";"0.10000";"2016.03.03 15:00:00";"113.503";"-35.00";"11836.30";"IST";"SL";"-35.00";"41.50";"13h 0m";""
"430";"USDJPY_M1";"Buy";"2016.03.04 05:00:00";"113.718";"0.10000";"2016.03.04 14:00:00";"113.368";"-35.00";"11801.30";"IST";"SL";"-35.00";"49.40";"9h 0m";""
"431";"USDJPY_M1";"Sell";"2016.03.04 16:00:00";"113.798";"0.10000";"2016.03.04 18:00:00";"114.148";"-35.00";"11766.30";"IST";"SL";"-35.00";"0.60";"2h 0m";""
"432";"USDJPY_M1";"Sell";"2016.03.07 00:00:00";"113.828";"0.10000";"2016.03.10 12:00:00";"114.178";"-35.00";"11731.30";"IST";"SL";"-35.00";"158.00";"3d 12h 0m";""
"433";"USDJPY_M1";"Sell";"2016.03.10 13:00:00";"114.153";"0.10000";"2016.03.11 21:00:00";"113.831";"32.20";"11763.50";"IST";"End Of Friday (Time)";"-9.50";"152.30";"1d 8h 0m";""
"434";"USDJPY_M1";"Sell";"2016.03.14 02:00:00";"113.935";"0.10000";"2016.03.17 04:00:00";"112.135";"180.00";"11943.50";"IST";"PT";"-22.10";"180.00";"3d 2h 0m";""
"435";"USDJPY_M1";"Buy";"2016.03.17 05:00:00";"112.059";"0.10000";"2016.03.17 07:00:00";"111.709";"-35.00";"11908.50";"IST";"SL";"-35.00";"21.70";"2h 0m";""
"436";"USDJPY_M1";"Buy";"2016.03.17 15:00:00";"111.434";"0.10000";"2016.03.17 16:00:00";"111.084";"-35.00";"11873.50";"IST";"SL";"-35.00";"19.30";"1h 0m";""
"437";"USDJPY_M1";"Buy";"2016.03.17 18:00:00";"111.376";"0.10000";"2016.03.18 00:00:00";"111.026";"-35.00";"11838.50";"IST";"SL";"-35.00";"18.50";"6h 0m";""
"438";"USDJPY_M1";"Buy";"2016.03.18 01:00:00";"111.054";"0.10000";"2016.03.20 21:00:00";"111.509";"45.50";"11884.00";"IST";"End Of Friday";"-2.90";"70.40";"2d 20h 0m";""
"439";"USDJPY_M1";"Sell";"2016.03.21 18:00:00";"111.784";"0.10000";"2016.03.21 22:00:00";"112.134";"-35.00";"11849.00";"IST";"SL";"-35.00";"1.80";"4h 0m";""
"440";"USDJPY_M1";"Sell";"2016.03.22 03:00:00";"112.012";"0.10000";"2016.03.22 17:00:00";"112.362";"-35.00";"11814.00";"IST";"SL";"-35.00";"61.30";"14h 0m";""
"441";"USDJPY_M1";"Sell";"2016.03.23 01:00:00";"112.224";"0.10000";"2016.03.23 08:00:00";"112.574";"-35.00";"11779.00";"IST";"SL";"-35.00";"6.30";"7h 0m";""
"442";"USDJPY_M1";"Sell";"2016.03.23 10:00:00";"112.661";"0.10000";"2016.03.24 07:00:00";"113.011";"-35.00";"11744.00";"IST";"SL";"-35.00";"34.70";"21h 0m";""
"443";"USDJPY_M1";"Sell";"2016.03.24 15:00:00";"112.542";"0.10000";"2016.03.24 20:00:00";"112.892";"-35.00";"11709.00";"IST";"SL";"-35.00";"1.80";"5h 0m";""
"444";"USDJPY_M1";"Sell";"2016.03.25 05:00:00";"113.136";"0.10000";"2016.03.27 21:00:00";"113.177";"-4.10";"11704.90";"IST";"End Of Friday";"-5.10";"23.10";"2d 16h 0m";""
"445";"USDJPY_M1";"Sell";"2016.03.27 22:00:00";"113.329";"0.10000";"2016.03.28 02:00:00";"113.679";"-35.00";"11669.90";"IST";"SL";"-35.00";"8.40";"4h 0m";""
"446";"USDJPY_M1";"Sell";"2016.03.28 07:00:00";"113.557";"0.10000";"2016.04.01 16:00:00";"111.757";"180.00";"11849.90";"IST";"PT";"-26.50";"180.00";"4d 9h 0m";""
"447";"USDJPY_M1";"Buy";"2016.04.01 17:00:00";"111.775";"0.10000";"2016.04.03 21:00:00";"111.602";"-17.30";"11832.60";"IST";"End Of Friday";"-19.20";"7.90";"2d 4h 0m";""
"448";"USDJPY_M1";"Buy";"2016.04.04 01:00:00";"111.467";"0.10000";"2016.04.04 17:00:00";"111.117";"-35.00";"11797.60";"IST";"SL";"-35.00";"27.20";"16h 0m";""
"449";"USDJPY_M1";"Buy";"2016.04.04 22:00:00";"111.335";"0.10000";"2016.04.05 00:00:00";"110.985";"-35.00";"11762.60";"IST";"SL";"-35.00";"0.00";"2h 0m";""
"450";"USDJPY_M1";"Buy";"2016.04.05 07:00:00";"110.437";"0.10000";"2016.04.05 15:00:00";"110.087";"-35.00";"11727.60";"IST";"SL";"-35.00";"38.60";"8h 0m";""
"451";"USDJPY_M1";"Buy";"2016.04.05 16:00:00";"110.097";"0.10000";"2016.04.06 15:00:00";"109.747";"-35.00";"11692.60";"IST";"SL";"-35.00";"54.10";"23h 0m";""
"452";"USDJPY_M1";"Sell";"2016.04.06 17:00:00";"109.719";"0.10000";"2016.04.07 14:00:00";"107.919";"180.00";"11872.60";"IST";"PT";"-20.40";"180.00";"21h 0m";""
"453";"USDJPY_M1";"Buy";"2016.04.07 15:00:00";"107.945";"0.10000";"2016.04.10 21:00:00";"107.968";"2.30";"11874.90";"IST";"End Of Friday";"0.00";"115.20";"3d 6h 0m";""
"454";"USDJPY_M1";"Buy";"2016.04.11 01:00:00";"108.040";"0.10000";"2016.04.11 01:00:00";"107.690";"-35.00";"11839.90";"IST";"SL";"-35.00";"0.00";"0s";""
"455";"USDJPY_M1";"Buy";"2016.04.11 08:00:00";"108.079";"0.10000";"2016.04.17 21:00:00";"108.158";"7.90";"11847.80";"IST";"End Of Friday";"-29.00";"165.10";"6d 13h 0m";""
"456";"USDJPY_M1";"Buy";"2016.04.17 21:00:00";"108.178";"0.10000";"2016.04.22 04:00:00";"109.978";"180.00";"12027.80";"IST";"PT";"-34.00";"180.00";"4d 7h 0m";""
"457";"USDJPY_M1";"Buy";"2016.04.22 05:00:00";"110.057";"0.10000";"2016.04.24 21:00:00";"111.830";"177.30";"12205.10";"IST";"End Of Friday";"0.00";"177.30";"2d 16h 0m";""
"458";"USDJPY_M1";"Sell";"2016.04.24 21:00:00";"111.830";"0.10000";"2016.04.28 03:00:00";"110.030";"180.00";"12385.10";"IST";"PT";"-7.30";"180.00";"3d 6h 0m";""
"459";"USDJPY_M1";"Sell";"2016.04.28 06:00:00";"108.959";"0.10000";"2016.04.29 01:00:00";"107.159";"180.00";"12565.10";"IST";"PT";"-2.00";"180.00";"19h 0m";""
"460";"USDJPY_M1";"Buy";"2016.04.29 08:00:00";"107.140";"0.10000";"2016.04.29 15:00:00";"106.790";"-35.00";"12530.10";"IST";"SL";"-35.00";"27.40";"7h 0m";""
"461";"USDJPY_M1";"Buy";"2016.04.29 16:00:00";"106.924";"0.10000";"2016.04.29 19:00:00";"106.574";"-35.00";"12495.10";"IST";"SL";"-35.00";"6.40";"3h 0m";""
"462";"USDJPY_M1";"Buy";"2016.05.01 21:00:00";"106.223";"0.10000";"2016.05.03 05:00:00";"105.873";"-35.00";"12460.10";"IST";"SL";"-35.00";"59.50";"1d 8h 0m";""
"463";"USDJPY_M1";"Buy";"2016.05.03 12:00:00";"105.891";"0.10000";"2016.05.08 21:00:00";"107.054";"116.30";"12576.40";"IST";"End Of Friday";"-0.50";"160.80";"5d 9h 0m";""
"464";"USDJPY_M1";"Buy";"2016.05.09 01:00:00";"107.490";"0.10000";"2016.05.10 16:00:00";"109.290";"180.00";"12756.40";"IST";"PT";"-25.90";"180.00";"1d 15h 0m";""
"465";"USDJPY_M1";"Sell";"2016.05.10 17:00:00";"109.281";"0.10000";"2016.05.15 21:00:00";"108.630";"65.10";"12821.50";"IST";"End Of Friday";"-29.30";"103.40";"5d 4h 0m";""
"466";"USDJPY_M1";"Buy";"2016.05.16 02:00:00";"108.883";"0.10000";"2016.05.22 21:00:00";"110.099";"121.60";"12943.10";"IST";"End Of Friday";"-24.50";"170.50";"6d 19h 0m";""
"467";"USDJPY_M1";"Sell";"2016.05.23 00:00:00";"110.030";"0.10000";"2016.05.25 12:00:00";"110.380";"-35.00";"12908.10";"IST";"SL";"-35.00";"89.90";"2d 12h 0m";""
"468";"USDJPY_M1";"Sell";"2016.05.25 14:00:00";"110.300";"0.10000";"2016.05.29 21:00:00";"110.431";"-13.10";"12895.00";"IST";"End Of Friday";"-16.70";"86.40";"4d 7h 0m";""
"469";"USDJPY_M1";"Sell";"2016.05.30 11:00:00";"111.111";"0.10000";"2016.06.01 11:00:00";"109.311";"180.00";"13075.00";"IST";"PT";"-25.80";"180.00";"2d 0h 0m";""
"470";"USDJPY_M1";"Buy";"2016.06.01 16:00:00";"109.575";"0.10000";"2016.06.02 01:00:00";"109.225";"-35.00";"13040.00";"IST";"SL";"-35.00";"12.20";"9h 0m";""
"471";"USDJPY_M1";"Buy";"2016.06.02 02:00:00";"109.222";"0.10000";"2016.06.02 02:00:00";"108.872";"-35.00";"13005.00";"IST";"SL";"-35.00";"0.00";"0s";""
"472";"USDJPY_M1";"Buy";"2016.06.02 07:00:00";"109.208";"0.10000";"2016.06.02 08:00:00";"108.858";"-35.00";"12970.00";"IST";"SL";"-35.00";"5.60";"1h 0m";""
"473";"USDJPY_M1";"Buy";"2016.06.02 09:00:00";"109.015";"0.10000";"2016.06.02 12:00:00";"108.665";"-35.00";"12935.00";"IST";"SL";"-35.00";"11.30";"3h 0m";""
"474";"USDJPY_M1";"Buy";"2016.06.02 18:00:00";"108.814";"0.10000";"2016.06.03 12:00:00";"108.464";"-35.00";"12900.00";"IST";"SL";"-35.00";"32.10";"18h 0m";""
"475";"USDJPY_M1";"Sell";"2016.06.03 15:00:00";"106.773";"0.10000";"2016.06.05 21:00:00";"106.567";"20.60";"12920.60";"IST";"End Of Friday";"-17.70";"24.40";"2d 6h 0m";""
"476";"USDJPY_M1";"Buy";"2016.06.05 22:00:00";"106.527";"0.10000";"2016.06.12 21:00:00";"106.800";"27.30";"12947.90";"IST";"End Of Friday";"-27.10";"137.60";"6d 23h 0m";""
"477";"USDJPY_M1";"Sell";"2016.06.12 21:00:00";"106.800";"0.10000";"2016.06.16 02:00:00";"105.000";"180.00";"13127.90";"IST";"PT";"-7.50";"180.00";"3d 5h 0m";""
"478";"USDJPY_M1";"Sell";"2016.06.16 03:00:00";"104.832";"0.10000";"2016.06.19 21:00:00";"104.681";"15.10";"13143.00";"IST";"End Of Friday";"-1.30";"126.20";"3d 18h 0m";""
"479";"USDJPY_M1";"Sell";"2016.06.20 04:00:00";"104.554";"0.10000";"2016.06.21 19:00:00";"104.904";"-35.00";"13108.00";"IST";"SL";"-35.00";"95.10";"1d 15h 0m";""
"480";"USDJPY_M1";"Sell";"2016.06.21 23:00:00";"104.680";"0.10000";"2016.06.23 09:00:00";"105.030";"-35.00";"13073.00";"IST";"SL";"-35.00";"63.50";"1d 10h 0m";""
"481";"USDJPY_M1";"Buy";"2016.06.23 12:00:00";"105.523";"0.10000";"2016.06.23 23:00:00";"105.173";"-35.00";"13038.00";"IST";"SL";"-35.00";"128.60";"11h 0m";""
"482";"USDJPY_M1";"Sell";"2016.06.24 01:00:00";"105.174";"0.10000";"2016.06.24 02:00:00";"103.374";"180.00";"13218.00";"IST";"PT";"0.00";"183.00";"1h 0m";""
"483";"USDJPY_M1";"Sell";"2016.06.24 03:00:00";"101.574";"0.10000";"2016.06.24 05:00:00";"101.924";"-35.00";"13183.00";"IST";"SL";"-35.00";"162.60";"2h 0m";""
"484";"USDJPY_M1";"Buy";"2016.06.24 08:00:00";"103.105";"0.10000";"2016.06.24 08:00:00";"102.755";"-35.00";"13148.00";"IST";"SL";"-35.00";"0.10";"0s";""
"485";"USDJPY_M1";"Buy";"2016.06.24 09:00:00";"102.978";"0.10000";"2016.06.24 10:00:00";"102.628";"-35.00";"13113.00";"IST";"SL";"-35.00";"20.00";"1h 0m";""
"486";"USDJPY_M1";"Buy";"2016.06.24 11:00:00";"102.156";"0.10000";"2016.06.26 21:00:00";"101.806";"-35.00";"13078.00";"IST";"SL";"-35.00";"60.50";"2d 10h 0m";""
"487";"USDJPY_M1";"Buy";"2016.06.26 21:00:00";"101.497";"0.10000";"2016.06.30 21:00:00";"103.297";"180.00";"13258.00";"IST";"PT";"-9.40";"180.00";"4d 0h 0m";""
"488";"USDJPY_M1";"Sell";"2016.06.30 23:00:00";"103.187";"0.10000";"2016.07.03 21:00:00";"102.621";"56.60";"13314.60";"IST";"End Of Friday";"0.00";"72.50";"2d 22h 0m";""
"489";"USDJPY_M1";"Buy";"2016.07.03 21:00:00";"102.621";"0.10000";"2016.07.05 00:00:00";"102.271";"-35.00";"13279.60";"IST";"SL";"-35.00";"18.10";"1d 3h 0m";""
"490";"USDJPY_M1";"Sell";"2016.07.05 03:00:00";"102.117";"0.10000";"2016.07.06 10:00:00";"100.317";"180.00";"13459.60";"IST";"PT";"-8.40";"180.00";"1d 7h 0m";""
"491";"USDJPY_M1";"Buy";"2016.07.06 14:00:00";"100.785";"0.10000";"2016.07.08 03:00:00";"100.435";"-35.00";"13424.60";"IST";"SL";"-35.00";"68.00";"1d 13h 0m";""
"492";"USDJPY_M1";"Buy";"2016.07.08 09:00:00";"100.617";"0.10000";"2016.07.08 12:00:00";"100.267";"-35.00";"13389.60";"IST";"SL";"-35.00";"13.00";"3h 0m";""
"493";"USDJPY_M1";"Buy";"2016.07.08 15:00:00";"100.568";"0.10000";"2016.07.10 21:00:00";"100.609";"4.10";"13393.70";"IST";"End Of Friday";"-14.30";"12.20";"2d 6h 0m";""
"494";"USDJPY_M1";"Buy";"2016.07.10 23:00:00";"100.672";"0.10000";"2016.07.11 11:00:00";"102.472";"180.00";"13573.70";"IST";"PT";"-11.40";"180.00";"12h 0m";""
"495";"USDJPY_M1";"Sell";"2016.07.11 16:00:00";"102.659";"0.10000";"2016.07.12 01:00:00";"103.009";"-35.00";"13538.70";"IST";"SL";"-35.00";"18.90";"9h 0m";""
"496";"USDJPY_M1";"Sell";"2016.07.12 02:00:00";"102.931";"0.10000";"2016.07.12 06:00:00";"103.281";"-35.00";"13503.70";"IST";"SL";"-35.00";"8.30";"4h 0m";""
"497";"USDJPY_M1";"Sell";"2016.07.12 07:00:00";"103.350";"0.10000";"2016.07.12 09:00:00";"103.700";"-35.00";"13468.70";"IST";"SL";"-35.00";"44.90";"2h 0m";""
"498";"USDJPY_M1";"Sell";"2016.07.12 10:00:00";"103.856";"0.10000";"2016.07.12 12:00:00";"104.206";"-35.00";"13433.70";"IST";"SL";"-35.00";"19.50";"2h 0m";""
"499";"USDJPY_M1";"Sell";"2016.07.12 21:00:00";"104.665";"0.10000";"2016.07.14 05:00:00";"105.015";"-35.00";"13398.70";"IST";"SL";"-35.00";"73.90";"1d 8h 0m";""
"500";"USDJPY_M1";"Sell";"2016.07.14 13:00:00";"105.826";"0.10000";"2016.07.15 02:00:00";"106.176";"-35.00";"13363.70";"IST";"SL";"-35.00";"75.80";"13h 0m";""
"501";"USDJPY_M1";"Sell";"2016.07.15 07:00:00";"105.598";"0.10000";"2016.07.15 07:00:00";"105.948";"-35.00";"13328.70";"IST";"SL";"-35.00";"0.00";"0s";""
"502";"USDJPY_M1";"Sell";"2016.07.15 13:00:00";"105.985";"0.10000";"2016.07.17 21:00:00";"105.338";"64.70";"13393.40";"IST";"End Of Friday";"-3.80";"133.60";"2d 8h 0m";""
"503";"USDJPY_M1";"Sell";"2016.07.17 23:00:00";"105.538";"0.10000";"2016.07.18 14:00:00";"105.888";"-35.00";"13358.40";"IST";"SL";"-35.00";"24.80";"15h 0m";""
"504";"USDJPY_M1";"Buy";"2016.07.18 17:00:00";"106.169";"0.10000";"2016.07.19 01:00:00";"105.819";"-35.00";"13323.40";"IST";"SL";"-35.00";"16.10";"8h 0m";""
"505";"USDJPY_M1";"Sell";"2016.07.19 02:00:00";"105.735";"0.10000";"2016.07.19 05:00:00";"106.085";"-35.00";"13288.40";"IST";"SL";"-35.00";"6.80";"3h 0m";""
"506";"USDJPY_M1";"Sell";"2016.07.19 09:00:00";"106.080";"0.10000";"2016.07.19 12:00:00";"106.430";"-35.00";"13253.40";"IST";"SL";"-35.00";"3.00";"3h 0m";""
"507";"USDJPY_M1";"Sell";"2016.07.19 18:00:00";"105.951";"0.10000";"2016.07.20 06:00:00";"106.301";"-35.00";"13218.40";"IST";"SL";"-35.00";"10.30";"12h 0m";""
"508";"USDJPY_M1";"Sell";"2016.07.20 16:00:00";"106.647";"0.10000";"2016.07.20 19:00:00";"106.997";"-35.00";"13183.40";"IST";"SL";"-35.00";"2.80";"3h 0m";""
"509";"USDJPY_M1";"Sell";"2016.07.20 23:00:00";"107.150";"0.10000";"2016.07.21 01:00:00";"107.500";"-35.00";"13148.40";"IST";"SL";"-35.00";"10.60";"2h 0m";""
"510";"USDJPY_M1";"Sell";"2016.07.21 04:00:00";"107.111";"0.10000";"2016.07.24 21:00:00";"106.122";"98.90";"13247.30";"IST";"End Of Friday";"-17.50";"167.30";"3d 17h 0m";""
"511";"USDJPY_M1";"Sell";"2016.07.25 08:00:00";"106.276";"0.10000";"2016.07.26 04:00:00";"104.476";"180.00";"13427.30";"IST";"PT";"-16.00";"180.00";"20h 0m";""
"512";"USDJPY_M1";"Buy";"2016.07.26 11:00:00";"104.444";"0.10000";"2016.07.27 03:00:00";"106.244";"180.00";"13607.30";"IST";"PT";"-20.00";"180.00";"16h 0m";""
"513";"USDJPY_M1";"Sell";"2016.07.27 07:00:00";"105.642";"0.10000";"2016.07.27 18:00:00";"105.992";"-35.00";"13572.30";"IST";"SL";"-35.00";"28.40";"11h 0m";""
"514";"USDJPY_M1";"Sell";"2016.07.27 19:00:00";"105.392";"0.10000";"2016.07.28 22:00:00";"103.592";"180.00";"13752.30";"IST";"PT";"-13.00";"180.00";"1d 3h 0m";""
"515";"USDJPY_M1";"Sell";"2016.07.29 01:00:00";"104.379";"0.10000";"2016.07.29 02:00:00";"104.729";"-35.00";"13717.30";"IST";"SL";"-35.00";"78.60";"1h 0m";""
"516";"USDJPY_M1";"Buy";"2016.07.29 05:00:00";"103.306";"0.10000";"2016.07.29 12:00:00";"102.956";"-35.00";"13682.30";"IST";"SL";"-35.00";"66.40";"7h 0m";""
"517";"USDJPY_M1";"Buy";"2016.07.29 14:00:00";"102.761";"0.10000";"2016.07.29 15:00:00";"102.411";"-35.00";"13647.30";"IST";"SL";"-35.00";"0.00";"1h 0m";""
"518";"USDJPY_M1";"Buy";"2016.07.31 22:00:00";"102.208";"0.10000";"2016.08.02 07:00:00";"101.858";"-35.00";"13612.30";"IST";"SL";"-35.00";"62.20";"1d 9h 0m";""
"519";"USDJPY_M1";"Sell";"2016.08.02 08:00:00";"101.663";"0.10000";"2016.08.05 14:00:00";"102.013";"-35.00";"13577.30";"IST";"SL";"-35.00";"96.40";"3d 6h 0m";""
"520";"USDJPY_M1";"Buy";"2016.08.05 15:00:00";"101.884";"0.10000";"2016.08.07 21:00:00";"101.984";"10.00";"13587.30";"IST";"End Of Friday";"-16.60";"10.00";"2d 6h 0m";""
"521";"USDJPY_M1";"Sell";"2016.08.07 21:00:00";"101.984";"0.10000";"2016.08.08 08:00:00";"102.334";"-35.00";"13552.30";"IST";"SL";"-35.00";"10.30";"11h 0m";""
"522";"USDJPY_M1";"Sell";"2016.08.08 13:00:00";"102.485";"0.10000";"2016.08.14 21:00:00";"101.138";"134.70";"13687.00";"IST";"End Of Friday";"-19.00";"163.20";"6d 8h 0m";""
"523";"USDJPY_M1";"Buy";"2016.08.14 21:00:00";"101.138";"0.10000";"2016.08.16 02:00:00";"100.788";"-35.00";"13652.00";"IST";"SL";"-35.00";"31.50";"1d 5h 0m";""
"524";"USDJPY_M1";"Sell";"2016.08.16 05:00:00";"100.521";"0.10000";"2016.08.17 04:00:00";"100.871";"-35.00";"13617.00";"IST";"SL";"-35.00";"96.00";"23h 0m";""
"525";"USDJPY_M1";"Buy";"2016.08.17 07:00:00";"100.923";"0.10000";"2016.08.17 13:00:00";"100.573";"-35.00";"13582.00";"IST";"SL";"-35.00";"2.10";"6h 0m";""
"526";"USDJPY_M1";"Sell";"2016.08.17 15:00:00";"100.259";"0.10000";"2016.08.17 18:00:00";"100.609";"-35.00";"13547.00";"IST";"SL";"-35.00";"7.60";"3h 0m";""
"527";"USDJPY_M1";"Sell";"2016.08.17 19:00:00";"100.191";"0.10000";"2016.08.21 21:00:00";"100.541";"-35.00";"13512.00";"IST";"SL";"-35.00";"52.70";"4d 2h 0m";""
"528";"USDJPY_M1";"Sell";"2016.08.22 09:00:00";"100.706";"0.10000";"2016.08.26 15:00:00";"101.056";"-35.00";"13477.00";"IST";"SL";"-35.00";"74.50";"4d 6h 0m";""
"529";"USDJPY_M1";"Buy";"2016.08.26 17:00:00";"101.302";"0.10000";"2016.08.28 21:00:00";"102.046";"74.40";"13551.40";"IST";"End Of Friday";"-2.00";"74.40";"2d 4h 0m";""
"530";"USDJPY_M1";"Sell";"2016.08.29 02:00:00";"102.103";"0.10000";"2016.08.30 07:00:00";"102.453";"-35.00";"13516.40";"IST";"SL";"-35.00";"33.00";"1d 5h 0m";""
"531";"USDJPY_M1";"Buy";"2016.08.30 13:00:00";"102.544";"0.10000";"2016.09.04 21:00:00";"104.072";"152.80";"13669.20";"IST";"End Of Friday";"0.00";"177.60";"5d 8h 0m";""
"532";"USDJPY_M1";"Sell";"2016.09.05 01:00:00";"103.901";"0.10000";"2016.09.06 14:00:00";"102.101";"180.00";"13849.20";"IST";"PT";"-16.20";"180.00";"1d 13h 0m";""
"533";"USDJPY_M1";"Sell";"2016.09.06 17:00:00";"102.151";"0.10000";"2016.09.08 16:00:00";"102.501";"-35.00";"13814.20";"IST";"SL";"-35.00";"92.80";"1d 23h 0m";""
"534";"USDJPY_M1";"Buy";"2016.09.08 18:00:00";"102.452";"0.10000";"2016.09.09 01:00:00";"102.102";"-35.00";"13779.20";"IST";"SL";"-35.00";"14.60";"7h 0m";""
"535";"USDJPY_M1";"Sell";"2016.09.09 02:00:00";"102.137";"0.10000";"2016.09.09 10:00:00";"102.487";"-35.00";"13744.20";"IST";"SL";"-35.00";"15.20";"8h 0m";""
"536";"USDJPY_M1";"Sell";"2016.09.09 11:00:00";"102.677";"0.10000";"2016.09.09 12:00:00";"103.027";"-35.00";"13709.20";"IST";"SL";"-35.00";"11.50";"1h 0m";""
"537";"USDJPY_M1";"Sell";"2016.09.09 17:00:00";"102.757";"0.10000";"2016.09.11 21:00:00";"102.552";"20.50";"13729.70";"IST";"End Of Friday";"0.00";"20.50";"2d 4h 0m";""
"538";"USDJPY_M1";"Sell";"2016.09.11 21:00:00";"102.532";"0.10000";"2016.09.14 00:00:00";"102.882";"-35.00";"13694.70";"IST";"SL";"-35.00";"109.40";"2d 3h 0m";""
"539";"USDJPY_M1";"Sell";"2016.09.14 01:00:00";"102.782";"0.10000";"2016.09.14 01:00:00";"103.132";"-35.00";"13659.70";"IST";"SL";"-35.00";"3.80";"0s";""
"540";"USDJPY_M1";"Sell";"2016.09.14 02:00:00";"103.050";"0.10000";"2016.09.18 21:00:00";"102.139";"91.10";"13750.80";"IST";"End Of Friday";"-32.70";"128.90";"4d 19h 0m";""
"541";"USDJPY_M1";"Sell";"2016.09.19 03:00:00";"102.065";"0.10000";"2016.09.21 04:00:00";"102.415";"-35.00";"13715.80";"IST";"SL";"-35.00";"103.30";"2d 1h 0m";""
"542";"USDJPY_M1";"Sell";"2016.09.21 05:00:00";"102.602";"0.10000";"2016.09.21 12:00:00";"100.802";"180.00";"13895.80";"IST";"PT";"-7.90";"180.00";"7h 0m";""
"543";"USDJPY_M1";"Sell";"2016.09.21 14:00:00";"100.762";"0.10000";"2016.09.23 00:00:00";"101.112";"-35.00";"13860.80";"IST";"SL";"-35.00";"64.40";"1d 10h 0m";""
"544";"USDJPY_M1";"Sell";"2016.09.23 07:00:00";"100.882";"0.10000";"2016.09.25 21:00:00";"100.963";"-8.10";"13852.70";"IST";"End Of Friday";"-30.10";"18.80";"2d 14h 0m";""
"545";"USDJPY_M1";"Buy";"2016.09.26 07:00:00";"100.866";"0.10000";"2016.09.26 07:00:00";"100.516";"-35.00";"13817.70";"IST";"SL";"-35.00";"0.00";"0s";""
"546";"USDJPY_M1";"Sell";"2016.09.26 08:00:00";"100.614";"0.10000";"2016.09.27 06:00:00";"100.964";"-35.00";"13782.70";"IST";"SL";"-35.00";"50.90";"22h 0m";""
"547";"USDJPY_M1";"Sell";"2016.09.27 10:00:00";"100.442";"0.10000";"2016.09.28 07:00:00";"100.792";"-35.00";"13747.70";"IST";"SL";"-35.00";"23.20";"21h 0m";""
"548";"USDJPY_M1";"Buy";"2016.09.28 17:00:00";"100.600";"0.10000";"2016.10.02 21:00:00";"101.210";"61.00";"13808.70";"IST";"End Of Friday";"-2.70";"124.00";"4d 4h 0m";""
"549";"USDJPY_M1";"Sell";"2016.10.03 03:00:00";"101.420";"0.10000";"2016.10.03 23:00:00";"101.770";"-35.00";"13773.70";"IST";"SL";"-35.00";"15.60";"20h 0m";""
"550";"USDJPY_M1";"Sell";"2016.10.04 11:00:00";"102.420";"0.10000";"2016.10.04 14:00:00";"102.770";"-35.00";"13738.70";"IST";"SL";"-35.00";"1.70";"3h 0m";""
"551";"USDJPY_M1";"Sell";"2016.10.04 15:00:00";"102.862";"0.10000";"2016.10.05 13:00:00";"103.212";"-35.00";"13703.70";"IST";"SL";"-35.00";"22.30";"22h 0m";""
"552";"USDJPY_M1";"Sell";"2016.10.05 15:00:00";"103.551";"0.10000";"2016.10.06 12:00:00";"103.901";"-35.00";"13668.70";"IST";"SL";"-35.00";"18.30";"21h 0m";""
"553";"USDJPY_M1";"Sell";"2016.10.06 19:00:00";"104.139";"0.10000";"2016.10.09 21:00:00";"103.267";"87.20";"13755.90";"IST";"End Of Friday";"0.00";"126.10";"3d 2h 0m";""
"554";"USDJPY_M1";"Buy";"2016.10.10 00:00:00";"103.056";"0.10000";"2016.10.16 21:00:00";"104.348";"129.20";"13885.10";"IST";"End Of Friday";"-24.80";"157.90";"6d 21h 0m";""
"555";"USDJPY_M1";"Sell";"2016.10.16 21:00:00";"104.348";"0.10000";"2016.10.23 21:00:00";"103.845";"50.30";"13935.40";"IST";"End Of Friday";"-4.30";"116.10";"7d 0h 0m";""
"556";"USDJPY_M1";"Buy";"2016.10.24 01:00:00";"103.925";"0.10000";"2016.10.30 21:00:00";"104.386";"46.10";"13981.50";"IST";"End Of Friday";"-20.50";"160.60";"6d 20h 0m";""
"557";"USDJPY_M1";"Sell";"2016.10.30 21:00:00";"104.386";"0.10000";"2016.10.31 00:00:00";"104.736";"-35.00";"13946.50";"IST";"SL";"-35.00";"0.00";"3h 0m";""
"558";"USDJPY_M1";"Buy";"2016.10.31 03:00:00";"104.880";"0.10000";"2016.11.01 14:00:00";"104.530";"-35.00";"13911.50";"IST";"SL";"-35.00";"35.10";"1d 11h 0m";""
"559";"USDJPY_M1";"Sell";"2016.11.01 17:00:00";"104.280";"0.10000";"2016.11.06 22:00:00";"104.013";"26.70";"13938.20";"IST";"End Of Friday";"0.00";"171.20";"5d 5h 0m";""
"560";"USDJPY_M1";"Sell";"2016.11.07 08:00:00";"104.446";"0.10000";"2016.11.08 11:00:00";"104.796";"-35.00";"13903.20";"IST";"SL";"-35.00";"17.40";"1d 3h 0m";""
"561";"USDJPY_M1";"Sell";"2016.11.08 17:00:00";"104.983";"0.10000";"2016.11.09 00:00:00";"105.333";"-35.00";"13868.20";"IST";"SL";"-35.00";"61.00";"7h 0m";""
"562";"USDJPY_M1";"Sell";"2016.11.09 01:00:00";"105.375";"0.10000";"2016.11.09 02:00:00";"103.575";"180.00";"14048.20";"IST";"PT";"0.00";"180.00";"1h 0m";""
"563";"USDJPY_M1";"Buy";"2016.11.09 03:00:00";"102.966";"0.10000";"2016.11.09 03:00:00";"102.616";"-35.00";"14013.20";"IST";"SL";"-35.00";"0.80";"0s";""
"564";"USDJPY_M1";"Sell";"2016.11.09 04:00:00";"101.838";"0.10000";"2016.11.09 06:00:00";"102.188";"-35.00";"13978.20";"IST";"SL";"-35.00";"62.70";"2h 0m";""
"565";"USDJPY_M1";"Buy";"2016.11.09 09:00:00";"103.414";"0.10000";"2016.11.09 10:00:00";"103.064";"-35.00";"13943.20";"IST";"SL";"-35.00";"18.10";"1h 0m";""
"566";"USDJPY_M1";"Buy";"2016.11.09 11:00:00";"103.073";"0.10000";"2016.11.09 16:00:00";"104.873";"180.00";"14123.20";"IST";"PT";"0.00";"180.00";"5h 0m";""
"567";"USDJPY_M1";"Buy";"2016.11.09 17:00:00";"104.860";"0.10000";"2016.11.10 10:00:00";"106.660";"180.00";"14303.20";"IST";"PT";"0.00";"180.00";"17h 0m";""
"568";"USDJPY_M1";"Sell";"2016.11.10 16:00:00";"106.456";"0.10000";"2016.11.10 16:00:00";"106.806";"-35.00";"14268.20";"IST";"SL";"-35.00";"0.40";"0s";""
"569";"USDJPY_M1";"Sell";"2016.11.10 18:00:00";"106.647";"0.10000";"2016.11.11 21:00:00";"106.751";"-10.40";"14257.80";"IST";"End Of Friday (Time)";"-31.50";"59.50";"1d 3h 0m";""
"570";"USDJPY_M1";"Buy";"2016.11.14 03:00:00";"107.476";"0.10000";"2016.11.15 19:00:00";"109.276";"180.00";"14437.80";"IST";"PT";"-13.00";"180.00";"1d 16h 0m";""
"571";"USDJPY_M1";"Sell";"2016.11.15 20:00:00";"109.315";"0.10000";"2016.11.16 10:00:00";"109.665";"-35.00";"14402.80";"IST";"SL";"-35.00";"50.30";"14h 0m";""
"572";"USDJPY_M1";"Sell";"2016.11.16 15:00:00";"109.225";"0.10000";"2016.11.16 15:00:00";"109.575";"-35.00";"14367.80";"IST";"SL";"-35.00";"7.10";"0s";""
"573";"USDJPY_M1";"Sell";"2016.11.16 16:00:00";"109.587";"0.10000";"2016.11.17 18:00:00";"109.937";"-35.00";"14332.80";"IST";"SL";"-35.00";"101.30";"1d 2h 0m";""
"574";"USDJPY_M1";"Buy";"2016.11.17 19:00:00";"109.978";"0.10000";"2016.11.18 21:00:00";"110.826";"84.80";"14417.60";"IST";"End Of Friday (Time)";"-17.90";"94.60";"1d 2h 0m";""
"575";"USDJPY_M1";"Sell";"2016.11.20 22:00:00";"110.918";"0.10000";"2016.11.21 18:00:00";"111.268";"-35.00";"14382.60";"IST";"SL";"-35.00";"42.30";"20h 0m";""
"576";"USDJPY_M1";"Sell";"2016.11.22 00:00:00";"110.658";"0.10000";"2016.11.22 06:00:00";"111.008";"-35.00";"14347.60";"IST";"SL";"-35.00";"36.90";"6h 0m";""
"577";"USDJPY_M1";"Buy";"2016.11.22 09:00:00";"110.832";"0.10000";"2016.11.23 15:00:00";"112.632";"180.00";"14527.60";"IST";"PT";"-27.60";"180.00";"1d 6h 0m";""
"578";"USDJPY_M1";"Buy";"2016.11.23 16:00:00";"112.990";"0.10000";"2016.11.23 16:00:00";"112.640";"-35.00";"14492.60";"IST";"SL";"-35.00";"0.00";"0s";""
"579";"USDJPY_M1";"Sell";"2016.11.23 21:00:00";"112.527";"0.10000";"2016.11.24 03:00:00";"112.877";"-35.00";"14457.60";"IST";"SL";"-35.00";"13.40";"6h 0m";""
"580";"USDJPY_M1";"Sell";"2016.11.24 04:00:00";"112.794";"0.10000";"2016.11.24 07:00:00";"113.144";"-35.00";"14422.60";"IST";"SL";"-35.00";"16.80";"3h 0m";""
"581";"USDJPY_M1";"Sell";"2016.11.24 08:00:00";"113.321";"0.10000";"2016.11.25 00:00:00";"113.671";"-35.00";"14387.60";"IST";"SL";"-35.00";"56.40";"16h 0m";""
"582";"USDJPY_M1";"Sell";"2016.11.25 02:00:00";"113.764";"0.10000";"2016.11.25 21:00:00";"113.077";"68.70";"14456.30";"IST";"End Of Friday (Time)";"0.00";"118.90";"19h 0m";""
"583";"USDJPY_M1";"Buy";"2016.11.27 22:00:00";"112.789";"0.10000";"2016.11.28 00:00:00";"112.439";"-35.00";"14421.30";"IST";"SL";"-35.00";"18.10";"2h 0m";""
"584";"USDJPY_M1";"Buy";"2016.11.28 08:00:00";"111.962";"0.10000";"2016.11.30 15:00:00";"113.762";"180.00";"14601.30";"IST";"PT";"-34.30";"180.00";"2d 7h 0m";""
"585";"USDJPY_M1";"Sell";"2016.12.01 00:00:00";"114.683";"0.10000";"2016.12.02 21:00:00";"113.599";"108.40";"14709.70";"IST";"End Of Friday (Time)";"-5.70";"133.40";"1d 21h 0m";""
"586";"USDJPY_M1";"Buy";"2016.12.05 02:00:00";"113.800";"0.10000";"2016.12.05 03:00:00";"113.450";"-35.00";"14674.70";"IST";"SL";"-35.00";"2.60";"1h 0m";""
"587";"USDJPY_M1";"Buy";"2016.12.05 04:00:00";"113.479";"0.10000";"2016.12.08 03:00:00";"113.129";"-35.00";"14639.70";"IST";"SL";"-35.00";"129.60";"2d 23h 0m";""
"588";"USDJPY_M1";"Buy";"2016.12.08 08:00:00";"113.666";"0.10000";"2016.12.08 11:00:00";"113.316";"-35.00";"14604.70";"IST";"SL";"-35.00";"1.80";"3h 0m";""
"589";"USDJPY_M1";"Buy";"2016.12.08 15:00:00";"114.147";"0.10000";"2016.12.09 21:00:00";"115.238";"109.10";"14713.80";"IST";"End Of Friday (Time)";"-21.30";"122.10";"1d 6h 0m";""
"590";"USDJPY_M1";"Sell";"2016.12.11 22:00:00";"115.406";"0.10000";"2016.12.12 07:00:00";"115.756";"-35.00";"14678.80";"IST";"SL";"-35.00";"22.80";"9h 0m";""
"591";"USDJPY_M1";"Sell";"2016.12.12 12:00:00";"115.701";"0.10000";"2016.12.14 19:00:00";"116.051";"-35.00";"14643.80";"IST";"SL";"-35.00";"94.40";"2d 7h 0m";""
"592";"USDJPY_M1";"Buy";"2016.12.14 20:00:00";"116.377";"0.10000";"2016.12.15 10:00:00";"118.177";"180.00";"14823.80";"IST";"PT";"0.00";"180.00";"14h 0m";""
"593";"USDJPY_M1";"Sell";"2016.12.15 11:00:00";"118.346";"0.10000";"2016.12.16 21:00:00";"117.938";"40.80";"14864.60";"IST";"End Of Friday (Time)";"-33.90";"85.60";"1d 10h 0m";""
"594";"USDJPY_M1";"Buy";"2016.12.19 10:00:00";"117.519";"0.10000";"2016.12.19 13:00:00";"117.169";"-35.00";"14829.60";"IST";"SL";"-35.00";"3.70";"3h 0m";""
"595";"USDJPY_M1";"Buy";"2016.12.19 17:00:00";"116.621";"0.10000";"2016.12.23 21:00:00";"117.367";"74.60";"14904.20";"IST";"End Of Friday (Time)";"-2.00";"162.00";"4d 4h 0m";""
"596";"USDJPY_M1";"Buy";"2016.12.25 22:00:00";"117.289";"0.10000";"2016.12.28 22:00:00";"116.939";"-35.00";"14869.20";"IST";"SL";"-35.00";"52.40";"3d 0h 0m";""
"597";"USDJPY_M1";"Sell";"2016.12.29 01:00:00";"116.977";"0.10000";"2016.12.30 21:00:00";"116.908";"6.90";"14876.10";"IST";"End Of Friday (Time)";"-23.70";"91.00";"1d 20h 0m";""
"598";"USDJPY_M1";"Sell";"2017.01.02 17:00:00";"117.376";"0.10000";"2017.01.03 07:00:00";"117.726";"-35.00";"14841.10";"IST";"SL";"-35.00";"14.10";"14h 0m";""
"599";"USDJPY_M1";"Sell";"2017.01.03 16:00:00";"118.031";"0.10000";"2017.01.05 05:00:00";"116.231";"180.00";"15021.10";"IST";"PT";"-17.40";"180.00";"1d 13h 0m";""
"600";"USDJPY_M1";"Buy";"2017.01.05 08:00:00";"115.970";"0.10000";"2017.01.05 15:00:00";"115.620";"-35.00";"14986.10";"IST";"SL";"-35.00";"82.10";"7h 0m";""
"601";"USDJPY_M1";"Buy";"2017.01.05 21:00:00";"115.583";"0.10000";"2017.01.05 23:00:00";"115.233";"-35.00";"14951.10";"IST";"SL";"-35.00";"0.00";"2h 0m";""
"602";"USDJPY_M1";"Buy";"2017.01.06 01:00:00";"115.748";"0.10000";"2017.01.06 21:00:00";"117.014";"126.60";"15077.70";"IST";"End Of Friday (Time)";"-8.30";"143.20";"20h 0m";""
"603";"USDJPY_M1";"Sell";"2017.01.08 23:00:00";"117.170";"0.10000";"2017.01.09 05:00:00";"117.520";"-35.00";"15042.70";"IST";"SL";"-35.00";"5.20";"6h 0m";""
"604";"USDJPY_M1";"Sell";"2017.01.09 08:00:00";"117.392";"0.10000";"2017.01.10 02:00:00";"115.592";"180.00";"15222.70";"IST";"PT";"-2.00";"180.00";"18h 0m";""
"605";"USDJPY_M1";"Buy";"2017.01.10 03:00:00";"115.649";"0.10000";"2017.01.10 03:00:00";"115.299";"-35.00";"15187.70";"IST";"SL";"-35.00";"5.30";"0s";""
"606";"USDJPY_M1";"Buy";"2017.01.10 04:00:00";"115.364";"0.10000";"2017.01.11 18:00:00";"115.014";"-35.00";"15152.70";"IST";"SL";"-35.00";"150.60";"1d 14h 0m";""
"607";"USDJPY_M1";"Sell";"2017.01.11 19:00:00";"114.994";"0.10000";"2017.01.11 19:00:00";"115.344";"-35.00";"15117.70";"IST";"SL";"-35.00";"13.00";"0s";""
"608";"USDJPY_M1";"Sell";"2017.01.11 20:00:00";"115.414";"0.10000";"2017.01.13 21:00:00";"114.597";"81.70";"15199.40";"IST";"End Of Friday (Time)";"-23.20";"163.70";"2d 1h 0m";""
"609";"USDJPY_M1";"Buy";"2017.01.16 10:00:00";"114.277";"0.10000";"2017.01.17 00:00:00";"113.927";"-35.00";"15164.40";"IST";"SL";"-35.00";"2.10";"14h 0m";""
"610";"USDJPY_M1";"Buy";"2017.01.17 15:00:00";"112.979";"0.10000";"2017.01.17 20:00:00";"112.629";"-35.00";"15129.40";"IST";"SL";"-35.00";"21.70";"5h 0m";""
"611";"USDJPY_M1";"Buy";"2017.01.17 21:00:00";"112.673";"0.10000";"2017.01.18 21:00:00";"114.473";"180.00";"15309.40";"IST";"PT";"-10.50";"180.00";"1d 0h 0m";""
"612";"USDJPY_M1";"Sell";"2017.01.19 05:00:00";"114.498";"0.10000";"2017.01.19 07:00:00";"114.848";"-35.00";"15274.40";"IST";"SL";"-35.00";"0.00";"2h 0m";""
"613";"USDJPY_M1";"Sell";"2017.01.19 08:00:00";"114.830";"0.10000";"2017.01.19 14:00:00";"115.180";"-35.00";"15239.40";"IST";"SL";"-35.00";"40.90";"6h 0m";""
"614";"USDJPY_M1";"Sell";"2017.01.19 15:00:00";"115.495";"0.10000";"2017.01.20 21:00:00";"114.508";"98.70";"15338.10";"IST";"End Of Friday (Time)";"-14.60";"126.40";"1d 6h 0m";""
"615";"USDJPY_M1";"Buy";"2017.01.23 07:00:00";"113.376";"0.10000";"2017.01.23 15:00:00";"113.026";"-35.00";"15303.10";"IST";"SL";"-35.00";"69.90";"8h 0m";""
"616";"USDJPY_M1";"Buy";"2017.01.23 16:00:00";"112.996";"0.10000";"2017.01.23 22:00:00";"112.646";"-35.00";"15268.10";"IST";"SL";"-35.00";"24.10";"6h 0m";""
"617";"USDJPY_M1";"Buy";"2017.01.23 23:00:00";"112.581";"0.10000";"2017.01.26 10:00:00";"114.381";"180.00";"15448.10";"IST";"PT";"-2.60";"180.00";"2d 11h 0m";""
"618";"USDJPY_M1";"Buy";"2017.01.26 12:00:00";"114.266";"0.10000";"2017.01.27 21:00:00";"115.136";"87.00";"15535.10";"IST";"End Of Friday (Time)";"-18.80";"111.00";"1d 9h 0m";""
"619";"USDJPY_M1";"Sell";"2017.01.29 22:00:00";"114.745";"0.10000";"2017.01.31 14:00:00";"112.945";"180.00";"15715.10";"IST";"PT";"-22.40";"180.00";"1d 16h 0m";""
"620";"USDJPY_M1";"Buy";"2017.01.31 20:00:00";"112.727";"0.10000";"2017.02.02 10:00:00";"112.377";"-35.00";"15680.10";"IST";"SL";"-35.00";"122.50";"1d 14h 0m";""
"621";"USDJPY_M1";"Sell";"2017.02.02 11:00:00";"112.362";"0.10000";"2017.02.02 16:00:00";"112.712";"-35.00";"15645.10";"IST";"SL";"-35.00";"28.90";"5h 0m";""
"622";"USDJPY_M1";"Buy";"2017.02.02 17:00:00";"112.495";"0.10000";"2017.02.03 21:00:00";"112.692";"19.70";"15664.80";"IST";"End Of Friday (Time)";"-17.80";"97.20";"1d 4h 0m";""
"623";"USDJPY_M1";"Sell";"2017.02.05 23:00:00";"112.568";"0.10000";"2017.02.09 15:00:00";"112.918";"-35.00";"15629.80";"IST";"SL";"-35.00";"95.40";"3d 16h 0m";""
"624";"USDJPY_M1";"Sell";"2017.02.09 23:00:00";"113.293";"0.10000";"2017.02.10 00:00:00";"113.643";"-35.00";"15594.80";"IST";"SL";"-35.00";"1.40";"1h 0m";""
"625";"USDJPY_M1";"Sell";"2017.02.10 01:00:00";"113.696";"0.10000";"2017.02.10 21:00:00";"113.376";"32.00";"15626.80";"IST";"End Of Friday (Time)";"-18.10";"81.60";"20h 0m";""
"626";"USDJPY_M1";"Sell";"2017.02.13 08:00:00";"113.539";"0.10000";"2017.02.13 13:00:00";"113.889";"-35.00";"15591.80";"IST";"SL";"-35.00";"8.10";"5h 0m";""
"627";"USDJPY_M1";"Sell";"2017.02.13 19:00:00";"113.683";"0.10000";"2017.02.14 15:00:00";"114.033";"-35.00";"15556.80";"IST";"SL";"-35.00";"41.30";"20h 0m";""
"628";"USDJPY_M1";"Buy";"2017.02.14 16:00:00";"114.417";"0.10000";"2017.02.15 16:00:00";"114.067";"-35.00";"15521.80";"IST";"SL";"-35.00";"54.00";"1d 0h 0m";""
"629";"USDJPY_M1";"Sell";"2017.02.15 17:00:00";"114.192";"0.10000";"2017.02.17 21:00:00";"112.936";"125.60";"15647.40";"IST";"End Of Friday (Time)";"-19.90";"155.40";"2d 4h 0m";""
"630";"USDJPY_M1";"Buy";"2017.02.19 22:00:00";"112.900";"0.10000";"2017.02.24 09:00:00";"112.550";"-35.00";"15612.40";"IST";"SL";"-35.00";"87.80";"4d 11h 0m";""
"631";"USDJPY_M1";"Buy";"2017.02.24 17:00:00";"112.288";"0.10000";"2017.02.24 20:00:00";"111.938";"-35.00";"15577.40";"IST";"SL";"-35.00";"0.00";"3h 0m";""
"632";"USDJPY_M1";"Buy";"2017.02.26 23:00:00";"112.248";"0.10000";"2017.02.28 15:00:00";"111.898";"-35.00";"15542.40";"IST";"SL";"-35.00";"59.30";"1d 16h 0m";""
"633";"USDJPY_M1";"Buy";"2017.02.28 19:00:00";"112.128";"0.10000";"2017.03.01 13:00:00";"113.928";"180.00";"15722.40";"IST";"PT";"0.00";"180.00";"18h 0m";""
"634";"USDJPY_M1";"Sell";"2017.03.01 17:00:00";"113.664";"0.10000";"2017.03.01 23:00:00";"114.014";"-35.00";"15687.40";"IST";"SL";"-35.00";"17.10";"6h 0m";""
"635";"USDJPY_M1";"Sell";"2017.03.02 05:00:00";"114.006";"0.10000";"2017.03.02 12:00:00";"114.356";"-35.00";"15652.40";"IST";"SL";"-35.00";"3.10";"7h 0m";""
"636";"USDJPY_M1";"Sell";"2017.03.02 13:00:00";"114.373";"0.10000";"2017.03.03 18:00:00";"114.723";"-35.00";"15617.40";"IST";"SL";"-35.00";"28.10";"1d 5h 0m";""
"637";"USDJPY_M1";"Sell";"2017.03.03 20:00:00";"114.125";"0.10000";"2017.03.03 21:00:00";"113.930";"19.50";"15636.90";"IST";"End Of Friday (Time)";"-2.00";"20.70";"1h 0m";""
"638";"USDJPY_M1";"Sell";"2017.03.05 22:00:00";"113.883";"0.10000";"2017.03.08 12:00:00";"114.233";"-35.00";"15601.90";"IST";"SL";"-35.00";"30.40";"2d 14h 0m";""
"639";"USDJPY_M1";"Buy";"2017.03.08 15:00:00";"114.540";"0.10000";"2017.03.10 21:00:00";"114.760";"22.00";"15623.90";"IST";"End Of Friday (Time)";"-27.50";"96.40";"2d 6h 0m";""
"640";"USDJPY_M1";"Buy";"2017.03.13 01:00:00";"114.862";"0.10000";"2017.03.13 06:00:00";"114.512";"-35.00";"15588.90";"IST";"SL";"-35.00";"5.60";"5h 0m";""
"641";"USDJPY_M1";"Buy";"2017.03.13 10:00:00";"114.641";"0.10000";"2017.03.15 18:00:00";"114.291";"-35.00";"15553.90";"IST";"SL";"-35.00";"55.20";"2d 8h 0m";""
"642";"USDJPY_M1";"Sell";"2017.03.15 21:00:00";"113.370";"0.10000";"2017.03.19 21:00:00";"112.682";"68.80";"15622.70";"IST";"End Of Friday";"-19.70";"78.60";"4d 0h 0m";""
"643";"USDJPY_M1";"Buy";"2017.03.19 22:00:00";"112.647";"0.10000";"2017.03.21 00:00:00";"112.297";"-35.00";"15587.70";"IST";"SL";"-35.00";"25.10";"1d 2h 0m";""
"644";"USDJPY_M1";"Buy";"2017.03.21 01:00:00";"112.401";"0.10000";"2017.03.21 15:00:00";"112.051";"-35.00";"15552.70";"IST";"SL";"-35.00";"46.50";"14h 0m";""
"645";"USDJPY_M1";"Buy";"2017.03.22 00:00:00";"111.554";"0.10000";"2017.03.22 09:00:00";"111.204";"-35.00";"15517.70";"IST";"SL";"-35.00";"21.50";"9h 0m";""
"646";"USDJPY_M1";"Buy";"2017.03.22 10:00:00";"111.357";"0.10000";"2017.03.22 13:00:00";"111.007";"-35.00";"15482.70";"IST";"SL";"-35.00";"7.60";"3h 0m";""
"647";"USDJPY_M1";"Buy";"2017.03.22 14:00:00";"110.990";"0.10000";"2017.03.23 13:00:00";"110.640";"-35.00";"15447.70";"IST";"SL";"-35.00";"58.90";"23h 0m";""
"648";"USDJPY_M1";"Buy";"2017.03.23 18:00:00";"111.062";"0.10000";"2017.03.24 19:00:00";"110.712";"-35.00";"15412.70";"IST";"SL";"-35.00";"41.90";"1d 1h 0m";""
"649";"USDJPY_M1";"Buy";"2017.03.26 22:00:00";"110.955";"0.10000";"2017.03.26 22:00:00";"110.605";"-35.00";"15377.70";"IST";"SL";"-35.00";"4.50";"0s";""
"650";"USDJPY_M1";"Buy";"2017.03.27 07:00:00";"110.215";"0.10000";"2017.03.31 00:00:00";"112.015";"180.00";"15557.70";"IST";"PT";"-10.60";"180.00";"3d 17h 0m";""
"651";"USDJPY_M1";"Sell";"2017.03.31 02:00:00";"112.046";"0.10000";"2017.04.02 21:00:00";"111.384";"66.20";"15623.90";"IST";"End Of Friday";"-17.10";"78.40";"2d 19h 0m";""
"652";"USDJPY_M1";"Buy";"2017.04.03 03:00:00";"111.372";"0.10000";"2017.04.03 14:00:00";"111.022";"-35.00";"15588.90";"IST";"SL";"-35.00";"21.70";"11h 0m";""
"653";"USDJPY_M1";"Sell";"2017.04.03 17:00:00";"111.016";"0.10000";"2017.04.05 13:00:00";"111.366";"-35.00";"15553.90";"IST";"SL";"-35.00";"72.60";"1d 20h 0m";""
"654";"USDJPY_M1";"Sell";"2017.04.05 21:00:00";"110.698";"0.10000";"2017.04.06 15:00:00";"111.048";"-35.00";"15518.90";"IST";"SL";"-35.00";"38.80";"18h 0m";""
"655";"USDJPY_M1";"Sell";"2017.04.06 19:00:00";"110.743";"0.10000";"2017.04.07 16:00:00";"111.093";"-35.00";"15483.90";"IST";"SL";"-35.00";"59.00";"21h 0m";""
"656";"USDJPY_M1";"Buy";"2017.04.07 18:00:00";"111.350";"0.10000";"2017.04.09 21:00:00";"111.034";"-31.60";"15452.30";"IST";"End Of Friday";"-31.70";"1.60";"2d 3h 0m";""
"657";"USDJPY_M1";"Sell";"2017.04.09 23:00:00";"111.300";"0.10000";"2017.04.12 00:00:00";"109.500";"180.00";"15632.30";"IST";"PT";"-30.00";"180.00";"2d 1h 0m";""
"658";"USDJPY_M1";"Buy";"2017.04.12 01:00:00";"109.442";"0.10000";"2017.04.12 20:00:00";"109.092";"-35.00";"15597.30";"IST";"SL";"-35.00";"42.50";"19h 0m";""
"659";"USDJPY_M1";"Buy";"2017.04.12 21:00:00";"109.033";"0.10000";"2017.04.14 12:00:00";"108.683";"-35.00";"15562.30";"IST";"SL";"-35.00";"36.10";"1d 15h 0m";""
"660";"USDJPY_M1";"Buy";"2017.04.14 19:00:00";"108.593";"0.10000";"2017.04.16 21:00:00";"108.696";"10.30";"15572.60";"IST";"End Of Friday";"-2.60";"10.30";"2d 2h 0m";""
"661";"USDJPY_M1";"Buy";"2017.04.16 21:00:00";"108.716";"0.10000";"2017.04.16 23:00:00";"108.366";"-35.00";"15537.60";"IST";"SL";"-35.00";"9.80";"2h 0m";""
"662";"USDJPY_M1";"Buy";"2017.04.17 00:00:00";"108.332";"0.10000";"2017.04.23 21:00:00";"110.132";"180.00";"15717.60";"IST";"PT";"-20.00";"180.00";"6d 21h 0m";""
"663";"USDJPY_M1";"Sell";"2017.04.24 06:00:00";"110.197";"0.10000";"2017.04.25 09:00:00";"110.547";"-35.00";"15682.60";"IST";"SL";"-35.00";"58.30";"1d 3h 0m";""
"664";"USDJPY_M1";"Sell";"2017.04.25 23:00:00";"110.984";"0.10000";"2017.04.26 00:00:00";"111.334";"-35.00";"15647.60";"IST";"SL";"-35.00";"0.00";"1h 0m";""
"665";"USDJPY_M1";"Sell";"2017.04.26 01:00:00";"111.289";"0.10000";"2017.04.26 12:00:00";"111.639";"-35.00";"15612.60";"IST";"SL";"-35.00";"15.00";"11h 0m";""
"666";"USDJPY_M1";"Sell";"2017.04.26 13:00:00";"111.455";"0.10000";"2017.04.30 21:00:00";"111.261";"19.40";"15632.00";"IST";"End Of Friday";"-34.30";"56.20";"4d 8h 0m";""
"667";"USDJPY_M1";"Sell";"2017.05.01 00:00:00";"111.310";"0.10000";"2017.05.01 01:00:00";"111.660";"-35.00";"15597.00";"IST";"SL";"-35.00";"0.00";"1h 0m";""
"668";"USDJPY_M1";"Buy";"2017.05.01 04:00:00";"111.686";"0.10000";"2017.05.07 21:00:00";"112.912";"122.60";"15719.60";"IST";"End Of Friday";"-25.60";"136.30";"6d 17h 0m";""
"669";"USDJPY_M1";"Buy";"2017.05.07 23:00:00";"112.846";"0.10000";"2017.05.08 09:00:00";"112.496";"-35.00";"15684.60";"IST";"SL";"-35.00";"3.30";"10h 0m";""
"670";"USDJPY_M1";"Sell";"2017.05.08 10:00:00";"112.515";"0.10000";"2017.05.08 14:00:00";"112.865";"-35.00";"15649.60";"IST";"SL";"-35.00";"9.90";"4h 0m";""
"671";"USDJPY_M1";"Sell";"2017.05.09 02:00:00";"113.201";"0.10000";"2017.05.09 07:00:00";"113.551";"-35.00";"15614.60";"IST";"SL";"-35.00";"0.60";"5h 0m";""
"672";"USDJPY_M1";"Sell";"2017.05.09 19:00:00";"114.274";"0.10000";"2017.05.14 21:00:00";"113.152";"112.20";"15726.80";"IST";"End Of Friday";"-11.60";"112.20";"5d 2h 0m";""
"673";"USDJPY_M1";"Buy";"2017.05.14 21:00:00";"113.152";"0.10000";"2017.05.16 22:00:00";"112.802";"-35.00";"15691.80";"IST";"SL";"-35.00";"69.90";"2d 1h 0m";""
"674";"USDJPY_M1";"Buy";"2017.05.16 23:00:00";"112.831";"0.10000";"2017.05.17 02:00:00";"112.481";"-35.00";"15656.80";"IST";"SL";"-35.00";"1.60";"3h 0m";""
"675";"USDJPY_M1";"Buy";"2017.05.17 07:00:00";"112.389";"0.10000";"2017.05.17 12:00:00";"112.039";"-35.00";"15621.80";"IST";"SL";"-35.00";"15.60";"5h 0m";""
"676";"USDJPY_M1";"Buy";"2017.05.17 14:00:00";"111.456";"0.10000";"2017.05.17 17:00:00";"111.106";"-35.00";"15586.80";"IST";"SL";"-35.00";"14.10";"3h 0m";""
"677";"USDJPY_M1";"Buy";"2017.05.18 01:00:00";"110.977";"0.10000";"2017.05.18 09:00:00";"110.627";"-35.00";"15551.80";"IST";"SL";"-35.00";"44.30";"8h 0m";""
"678";"USDJPY_M1";"Buy";"2017.05.18 14:00:00";"111.024";"0.10000";"2017.05.21 21:00:00";"110.981";"-4.30";"15547.50";"IST";"End Of Friday";"-30.40";"71.50";"3d 7h 0m";""
"679";"USDJPY_M1";"Buy";"2017.05.22 03:00:00";"111.487";"0.10000";"2017.05.22 13:00:00";"111.137";"-35.00";"15512.50";"IST";"SL";"-35.00";"8.60";"10h 0m";""
"680";"USDJPY_M1";"Sell";"2017.05.22 15:00:00";"111.063";"0.10000";"2017.05.23 15:00:00";"111.413";"-35.00";"15477.50";"IST";"SL";"-35.00";"18.10";"1d 0h 0m";""
"681";"USDJPY_M1";"Buy";"2017.05.23 18:00:00";"111.557";"0.10000";"2017.05.26 07:00:00";"111.207";"-35.00";"15442.50";"IST";"SL";"-35.00";"57.00";"2d 13h 0m";""
"682";"USDJPY_M1";"Buy";"2017.05.26 14:00:00";"111.262";"0.10000";"2017.05.28 21:00:00";"111.205";"-5.70";"15436.80";"IST";"End Of Friday";"-15.30";"16.60";"2d 7h 0m";""
"683";"USDJPY_M1";"Buy";"2017.05.28 21:00:00";"111.225";"0.10000";"2017.05.30 01:00:00";"110.875";"-35.00";"15401.80";"IST";"SL";"-35.00";"24.40";"1d 4h 0m";""
"684";"USDJPY_M1";"Sell";"2017.05.30 03:00:00";"110.843";"0.10000";"2017.05.30 12:00:00";"111.193";"-35.00";"15366.80";"IST";"SL";"-35.00";"0.90";"9h 0m";""
"685";"USDJPY_M1";"Buy";"2017.05.30 13:00:00";"111.141";"0.10000";"2017.05.30 15:00:00";"110.791";"-35.00";"15331.80";"IST";"SL";"-35.00";"0.00";"2h 0m";""
"686";"USDJPY_M1";"Buy";"2017.05.30 16:00:00";"110.704";"0.10000";"2017.06.02 15:00:00";"110.354";"-35.00";"15296.80";"IST";"SL";"-35.00";"100.70";"2d 23h 0m";""
"687";"USDJPY_M1";"Sell";"2017.06.02 16:00:00";"110.502";"0.10000";"2017.06.04 21:00:00";"110.361";"14.10";"15310.90";"IST";"End Of Friday";"-9.10";"14.10";"2d 5h 0m";""
"688";"USDJPY_M1";"Buy";"2017.06.04 21:00:00";"110.361";"0.10000";"2017.06.06 01:00:00";"110.011";"-35.00";"15275.90";"IST";"SL";"-35.00";"37.00";"1d 4h 0m";""
"689";"USDJPY_M1";"Sell";"2017.06.06 03:00:00";"109.825";"0.10000";"2017.06.08 11:00:00";"110.175";"-35.00";"15240.90";"IST";"SL";"-35.00";"68.90";"2d 8h 0m";""
"690";"USDJPY_M1";"Sell";"2017.06.08 15:00:00";"110.120";"0.10000";"2017.06.09 06:00:00";"110.470";"-35.00";"15205.90";"IST";"SL";"-35.00";"37.10";"15h 0m";""
"691";"USDJPY_M1";"Sell";"2017.06.09 07:00:00";"110.389";"0.10000";"2017.06.09 13:00:00";"110.739";"-35.00";"15170.90";"IST";"SL";"-35.00";"8.70";"6h 0m";""
"692";"USDJPY_M1";"Sell";"2017.06.09 18:00:00";"110.371";"0.10000";"2017.06.11 21:00:00";"110.318";"5.30";"15176.20";"IST";"End Of Friday";"0.00";"21.90";"2d 3h 0m";""
"693";"USDJPY_M1";"Sell";"2017.06.11 21:00:00";"110.298";"0.10000";"2017.06.15 14:00:00";"110.648";"-35.00";"15141.20";"IST";"SL";"-35.00";"146.40";"3d 17h 0m";""
"694";"USDJPY_M1";"Sell";"2017.06.15 22:00:00";"110.875";"0.10000";"2017.06.16 02:00:00";"111.225";"-35.00";"15106.20";"IST";"SL";"-35.00";"1.40";"4h 0m";""
"695";"USDJPY_M1";"Sell";"2017.06.16 03:00:00";"111.114";"0.10000";"2017.06.18 21:00:00";"110.889";"22.50";"15128.70";"IST";"End Of Friday";"-32.30";"44.80";"2d 18h 0m";""
"696";"USDJPY_M1";"Buy";"2017.06.19 03:00:00";"111.007";"0.10000";"2017.06.25 21:00:00";"111.103";"9.60";"15138.30";"IST";"End Of Friday";"-9.80";"78.00";"6d 18h 0m";""
"697";"USDJPY_M1";"Sell";"2017.06.26 00:00:00";"111.236";"0.10000";"2017.06.26 08:00:00";"111.586";"-35.00";"15103.30";"IST";"SL";"-35.00";"0.30";"8h 0m";""
"698";"USDJPY_M1";"Sell";"2017.06.26 15:00:00";"111.434";"0.10000";"2017.06.26 18:00:00";"111.784";"-35.00";"15068.30";"IST";"SL";"-35.00";"2.80";"3h 0m";""
"699";"USDJPY_M1";"Sell";"2017.06.27 01:00:00";"111.965";"0.10000";"2017.06.27 15:00:00";"112.315";"-35.00";"15033.30";"IST";"SL";"-35.00";"48.40";"14h 0m";""
"700";"USDJPY_M1";"Sell";"2017.06.27 20:00:00";"112.171";"0.10000";"2017.06.29 07:00:00";"112.521";"-35.00";"14998.30";"IST";"SL";"-35.00";"32.10";"1d 11h 0m";""
"701";"USDJPY_M1";"Sell";"2017.06.29 12:00:00";"112.681";"0.10000";"2017.07.02 21:00:00";"112.078";"60.30";"15058.60";"IST";"End Of Friday";"-26.40";"92.80";"3d 9h 0m";""
"702";"USDJPY_M1";"Sell";"2017.07.03 02:00:00";"112.356";"0.10000";"2017.07.03 07:00:00";"112.706";"-35.00";"15023.60";"IST";"SL";"-35.00";"0.30";"5h 0m";""
"703";"USDJPY_M1";"Sell";"2017.07.03 15:00:00";"113.301";"0.10000";"2017.07.05 10:00:00";"113.651";"-35.00";"14988.60";"IST";"SL";"-35.00";"54.10";"1d 19h 0m";""
"704";"USDJPY_M1";"Sell";"2017.07.05 14:00:00";"113.442";"0.10000";"2017.07.07 02:00:00";"113.792";"-35.00";"14953.60";"IST";"SL";"-35.00";"53.60";"1d 12h 0m";""
"705";"USDJPY_M1";"Buy";"2017.07.07 04:00:00";"113.655";"0.10000";"2017.07.09 21:00:00";"113.863";"20.80";"14974.40";"IST";"End Of Friday";"-15.30";"52.40";"2d 17h 0m";""
"706";"USDJPY_M1";"Sell";"2017.07.09 21:00:00";"113.863";"0.10000";"2017.07.10 01:00:00";"114.213";"-35.00";"14939.40";"IST";"SL";"-35.00";"0.00";"4h 0m";""
"707";"USDJPY_M1";"Sell";"2017.07.10 02:00:00";"114.193";"0.10000";"2017.07.14 12:00:00";"112.393";"180.00";"15119.40";"IST";"PT";"-32.10";"180.00";"4d 10h 0m";""
"708";"USDJPY_M1";"Sell";"2017.07.14 15:00:00";"112.608";"0.10000";"2017.07.16 21:00:00";"112.462";"14.60";"15134.00";"IST";"End Of Friday";"-11.60";"14.60";"2d 6h 0m";""
"709";"USDJPY_M1";"Buy";"2017.07.16 21:00:00";"112.462";"0.10000";"2017.07.18 02:00:00";"112.112";"-35.00";"15099.00";"IST";"SL";"-35.00";"40.50";"1d 5h 0m";""
"710";"USDJPY_M1";"Sell";"2017.07.18 03:00:00";"112.143";"0.10000";"2017.07.23 21:00:00";"111.121";"102.20";"15201.20";"IST";"End Of Friday";"-29.50";"111.10";"5d 18h 0m";""
"711";"USDJPY_M1";"Buy";"2017.07.23 22:00:00";"111.173";"0.10000";"2017.07.24 00:00:00";"110.823";"-35.00";"15166.20";"IST";"SL";"-35.00";"0.00";"2h 0m";""
"712";"USDJPY_M1";"Buy";"2017.07.24 01:00:00";"110.930";"0.10000";"2017.07.28 19:00:00";"110.580";"-35.00";"15131.20";"IST";"SL";"-35.00";"126.90";"4d 18h 0m";""
"713";"USDJPY_M1";"Buy";"2017.07.30 23:00:00";"110.557";"0.10000";"2017.08.01 02:00:00";"110.207";"-35.00";"15096.20";"IST";"SL";"-35.00";"21.70";"1d 3h 0m";""
"714";"USDJPY_M1";"Buy";"2017.08.01 03:00:00";"110.135";"0.10000";"2017.08.06 21:00:00";"110.707";"57.20";"15153.40";"IST";"End Of Friday";"-29.00";"91.30";"5d 18h 0m";""
"715";"USDJPY_M1";"Sell";"2017.08.06 21:00:00";"110.707";"0.10000";"2017.08.11 12:00:00";"108.907";"180.00";"15333.40";"IST";"PT";"-23.20";"180.00";"4d 15h 0m";""
"716";"USDJPY_M1";"Buy";"2017.08.11 14:00:00";"109.123";"0.10000";"2017.08.13 21:00:00";"109.155";"3.20";"15336.60";"IST";"End Of Friday";"-20.50";"10.60";"2d 7h 0m";""
"717";"USDJPY_M1";"Buy";"2017.08.13 22:00:00";"109.111";"0.10000";"2017.08.16 07:00:00";"110.911";"180.00";"15516.60";"IST";"PT";"-2.00";"180.00";"2d 9h 0m";""
"718";"USDJPY_M1";"Sell";"2017.08.16 08:00:00";"110.872";"0.10000";"2017.08.18 07:00:00";"109.072";"180.00";"15696.60";"IST";"PT";"-9.60";"180.00";"1d 23h 0m";""
"719";"USDJPY_M1";"Buy";"2017.08.18 08:00:00";"109.070";"0.10000";"2017.08.18 13:00:00";"108.720";"-35.00";"15661.60";"IST";"SL";"-35.00";"10.20";"5h 0m";""
"720";"USDJPY_M1";"Buy";"2017.08.18 14:00:00";"108.691";"0.10000";"2017.08.20 21:00:00";"109.343";"65.20";"15726.80";"IST";"End Of Friday";"-1.00";"90.80";"2d 7h 0m";""
"721";"USDJPY_M1";"Buy";"2017.08.20 21:00:00";"109.363";"0.10000";"2017.08.21 07:00:00";"109.013";"-35.00";"15691.80";"IST";"SL";"-35.00";"6.00";"10h 0m";""
"722";"USDJPY_M1";"Buy";"2017.08.21 18:00:00";"108.728";"0.10000";"2017.08.27 21:00:00";"109.163";"43.50";"15735.30";"IST";"End Of Friday";"0.00";"111.40";"6d 3h 0m";""
"723";"USDJPY_M1";"Buy";"2017.08.27 22:00:00";"109.266";"0.10000";"2017.08.28 21:00:00";"108.916";"-35.00";"15700.30";"IST";"SL";"-35.00";"14.70";"23h 0m";""
"724";"USDJPY_M1";"Buy";"2017.08.28 22:00:00";"108.813";"0.10000";"2017.08.28 22:00:00";"108.463";"-35.00";"15665.30";"IST";"SL";"-35.00";"1.00";"0s";""
"725";"USDJPY_M1";"Sell";"2017.08.29 00:00:00";"108.727";"0.10000";"2017.08.29 15:00:00";"109.077";"-35.00";"15630.30";"IST";"SL";"-35.00";"44.10";"15h 0m";""
"726";"USDJPY_M1";"Buy";"2017.08.29 16:00:00";"109.049";"0.10000";"2017.09.03 21:00:00";"109.506";"45.70";"15676.00";"IST";"End Of Friday";"0.00";"162.10";"5d 5h 0m";""
"727";"USDJPY_M1";"Buy";"2017.09.04 05:00:00";"109.828";"0.10000";"2017.09.04 06:00:00";"109.478";"-35.00";"15641.00";"IST";"SL";"-35.00";"0.00";"1h 0m";""
"728";"USDJPY_M1";"Buy";"2017.09.04 07:00:00";"109.505";"0.10000";"2017.09.05 12:00:00";"109.155";"-35.00";"15606.00";"IST";"SL";"-35.00";"32.80";"1d 5h 0m";""
"729";"USDJPY_M1";"Buy";"2017.09.05 14:00:00";"109.270";"0.10000";"2017.09.05 14:00:00";"108.920";"-35.00";"15571.00";"IST";"SL";"-35.00";"0.00";"0s";""
"730";"USDJPY_M1";"Sell";"2017.09.05 17:00:00";"108.749";"0.10000";"2017.09.06 13:00:00";"109.099";"-35.00";"15536.00";"IST";"SL";"-35.00";"27.60";"20h 0m";""
"731";"USDJPY_M1";"Buy";"2017.09.06 19:00:00";"109.355";"0.10000";"2017.09.07 00:00:00";"109.005";"-35.00";"15501.00";"IST";"SL";"-35.00";"2.70";"5h 0m";""
"732";"USDJPY_M1";"Sell";"2017.09.07 01:00:00";"109.139";"0.10000";"2017.09.08 12:00:00";"107.339";"180.00";"15681.00";"IST";"PT";"-0.60";"180.00";"1d 11h 0m";""
"733";"USDJPY_M1";"Buy";"2017.09.08 15:00:00";"107.939";"0.10000";"2017.09.10 21:00:00";"108.156";"21.70";"15702.70";"IST";"End Of Friday";"-31.20";"21.70";"2d 6h 0m";""
"734";"USDJPY_M1";"Buy";"2017.09.10 21:00:00";"108.176";"0.10000";"2017.09.12 12:00:00";"109.976";"180.00";"15882.70";"IST";"PT";"-1.00";"180.00";"1d 15h 0m";""
"735";"USDJPY_M1";"Sell";"2017.09.12 17:00:00";"110.041";"0.10000";"2017.09.13 14:00:00";"110.391";"-35.00";"15847.70";"IST";"SL";"-35.00";"11.60";"21h 0m";""
"736";"USDJPY_M1";"Sell";"2017.09.13 20:00:00";"110.631";"0.10000";"2017.09.14 12:00:00";"110.981";"-35.00";"15812.70";"IST";"SL";"-35.00";"25.80";"16h 0m";""
"737";"USDJPY_M1";"Sell";"2017.09.14 15:00:00";"110.704";"0.10000";"2017.09.15 09:00:00";"111.054";"-35.00";"15777.70";"IST";"SL";"-35.00";"113.40";"18h 0m";""
"738";"USDJPY_M1";"Buy";"2017.09.15 12:00:00";"111.265";"0.10000";"2017.09.15 12:00:00";"110.915";"-35.00";"15742.70";"IST";"SL";"-35.00";"0.00";"0s";""
"739";"USDJPY_M1";"Sell";"2017.09.15 15:00:00";"111.046";"0.10000";"2017.09.17 21:00:00";"111.075";"-2.90";"15739.80";"IST";"End Of Friday";"-2.90";"26.80";"2d 6h 0m";""
"740";"USDJPY_M1";"Sell";"2017.09.18 06:00:00";"111.175";"0.10000";"2017.09.18 14:00:00";"111.525";"-35.00";"15704.80";"IST";"SL";"-35.00";"0.00";"8h 0m";""
"741";"USDJPY_M1";"Sell";"2017.09.18 16:00:00";"111.475";"0.10000";"2017.09.19 05:00:00";"111.825";"-35.00";"15669.80";"IST";"SL";"-35.00";"8.40";"13h 0m";""
"742";"USDJPY_M1";"Sell";"2017.09.19 10:00:00";"111.670";"0.10000";"2017.09.20 18:00:00";"112.020";"-35.00";"15634.80";"IST";"SL";"-35.00";"54.40";"1d 8h 0m";""
"743";"USDJPY_M1";"Buy";"2017.09.20 21:00:00";"112.226";"0.10000";"2017.09.22 02:00:00";"111.876";"-35.00";"15599.80";"IST";"SL";"-35.00";"48.90";"1d 5h 0m";""
"744";"USDJPY_M1";"Buy";"2017.09.22 08:00:00";"112.030";"0.10000";"2017.09.24 21:00:00";"112.138";"10.80";"15610.60";"IST";"End Of Friday";"-18.10";"14.30";"2d 13h 0m";""
"745";"USDJPY_M1";"Buy";"2017.09.24 21:00:00";"112.158";"0.10000";"2017.09.25 14:00:00";"111.808";"-35.00";"15575.60";"IST";"SL";"-35.00";"37.00";"17h 0m";""
"746";"USDJPY_M1";"Sell";"2017.09.25 17:00:00";"111.564";"0.10000";"2017.09.26 11:00:00";"111.914";"-35.00";"15540.60";"IST";"SL";"-35.00";"4.60";"18h 0m";""
"747";"USDJPY_M1";"Buy";"2017.09.26 12:00:00";"111.969";"0.10000";"2017.10.01 21:00:00";"112.642";"67.30";"15607.90";"IST";"End Of Friday";"0.00";"128.80";"5d 9h 0m";""
"748";"USDJPY_M1";"Sell";"2017.10.02 11:00:00";"112.777";"0.10000";"2017.10.03 01:00:00";"113.127";"-35.00";"15572.90";"IST";"SL";"-35.00";"22.50";"14h 0m";""
"749";"USDJPY_M1";"Buy";"2017.10.03 03:00:00";"113.093";"0.10000";"2017.10.03 14:00:00";"112.743";"-35.00";"15537.90";"IST";"SL";"-35.00";"10.20";"11h 0m";""
"750";"USDJPY_M1";"Sell";"2017.10.03 15:00:00";"112.756";"0.10000";"2017.10.06 12:00:00";"113.106";"-35.00";"15502.90";"IST";"SL";"-35.00";"41.30";"2d 21h 0m";""
"751";"USDJPY_M1";"Sell";"2017.10.06 13:00:00";"113.315";"0.10000";"2017.10.08 21:00:00";"112.585";"73.00";"15575.90";"IST";"End Of Friday";"-14.30";"73.00";"2d 8h 0m";""
"752";"USDJPY_M1";"Buy";"2017.10.09 00:00:00";"112.562";"0.10000";"2017.10.10 13:00:00";"112.212";"-35.00";"15540.90";"IST";"SL";"-35.00";"26.60";"1d 13h 0m";""
"753";"USDJPY_M1";"Buy";"2017.10.10 15:00:00";"112.044";"0.10000";"2017.10.13 12:00:00";"111.694";"-35.00";"15505.90";"IST";"SL";"-35.00";"54.00";"2d 21h 0m";""
"754";"USDJPY_M1";"Buy";"2017.10.13 13:00:00";"111.831";"0.10000";"2017.10.15 21:00:00";"111.751";"-8.00";"15497.90";"IST";"End Of Friday";"-14.50";"14.80";"2d 8h 0m";""
"755";"USDJPY_M1";"Buy";"2017.10.15 21:00:00";"111.771";"0.10000";"2017.10.22 21:00:00";"113.571";"180.00";"15677.90";"IST";"PT";"-11.80";"180.00";"7d 0h 0m";""
"756";"USDJPY_M1";"Sell";"2017.10.22 22:00:00";"113.835";"0.10000";"2017.10.25 09:00:00";"114.185";"-35.00";"15642.90";"IST";"SL";"-35.00";"57.10";"2d 11h 0m";""
"757";"USDJPY_M1";"Sell";"2017.10.25 14:00:00";"113.882";"0.10000";"2017.10.27 01:00:00";"114.232";"-35.00";"15607.90";"IST";"SL";"-35.00";"52.10";"1d 11h 0m";""
"758";"USDJPY_M1";"Sell";"2017.10.27 05:00:00";"114.152";"0.10000";"2017.10.29 21:00:00";"113.738";"41.40";"15649.30";"IST";"End Of Friday";"-31.80";"48.80";"2d 16h 0m";""
"759";"USDJPY_M1";"Buy";"2017.10.30 04:00:00";"113.610";"0.10000";"2017.10.30 15:00:00";"113.260";"-35.00";"15614.30";"IST";"SL";"-35.00";"15.00";"11h 0m";""
"760";"USDJPY_M1";"Buy";"2017.10.30 23:00:00";"113.156";"0.10000";"2017.11.05 22:00:00";"114.002";"84.60";"15698.90";"IST";"End Of Friday";"-20.10";"127.10";"5d 23h 0m";""
"761";"USDJPY_M1";"Sell";"2017.11.05 22:00:00";"114.002";"0.10000";"2017.11.06 00:00:00";"114.352";"-35.00";"15663.90";"IST";"SL";"-35.00";"0.00";"2h 0m";""
"762";"USDJPY_M1";"Sell";"2017.11.06 01:00:00";"114.397";"0.10000";"2017.11.06 01:00:00";"114.747";"-35.00";"15628.90";"IST";"SL";"-35.00";"2.60";"0s";""
"763";"USDJPY_M1";"Buy";"2017.11.06 03:00:00";"114.334";"0.10000";"2017.11.06 11:00:00";"113.984";"-35.00";"15593.90";"IST";"SL";"-35.00";"9.50";"8h 0m";""
"764";"USDJPY_M1";"Sell";"2017.11.06 13:00:00";"114.126";"0.10000";"2017.11.10 21:00:00";"113.552";"57.40";"15651.30";"IST";"End Of Friday (Time)";"-23.30";"101.50";"4d 8h 0m";""
"765";"USDJPY_M1";"Sell";"2017.11.13 08:00:00";"113.456";"0.10000";"2017.11.14 08:00:00";"113.806";"-35.00";"15616.30";"IST";"SL";"-35.00";"19.20";"1d 0h 0m";""
"766";"USDJPY_M1";"Sell";"2017.11.14 13:00:00";"113.560";"0.10000";"2017.11.17 21:00:00";"112.103";"145.70";"15762.00";"IST";"End Of Friday (Time)";"-6.30";"159.50";"3d 8h 0m";""
"767";"USDJPY_M1";"Buy";"2017.11.19 22:00:00";"112.131";"0.10000";"2017.11.22 14:00:00";"111.781";"-35.00";"15727.00";"IST";"SL";"-35.00";"58.80";"2d 16h 0m";""
"768";"USDJPY_M1";"Buy";"2017.11.22 15:00:00";"111.821";"0.10000";"2017.11.22 19:00:00";"111.471";"-35.00";"15692.00";"IST";"SL";"-35.00";"3.60";"4h 0m";""
"769";"USDJPY_M1";"Buy";"2017.11.23 01:00:00";"111.146";"0.10000";"2017.11.24 21:00:00";"111.570";"42.40";"15734.40";"IST";"End Of Friday (Time)";"-4.10";"47.70";"1d 20h 0m";""
"770";"USDJPY_M1";"Sell";"2017.11.27 00:00:00";"111.661";"0.10000";"2017.11.29 13:00:00";"112.011";"-35.00";"15699.40";"IST";"SL";"-35.00";"80.00";"2d 13h 0m";""
"771";"USDJPY_M1";"Sell";"2017.11.29 19:00:00";"111.916";"0.10000";"2017.11.30 07:00:00";"112.266";"-35.00";"15664.40";"IST";"SL";"-35.00";"12.30";"12h 0m";""
"772";"USDJPY_M1";"Sell";"2017.11.30 16:00:00";"111.902";"0.10000";"2017.11.30 16:00:00";"112.252";"-35.00";"15629.40";"IST";"SL";"-35.00";"3.10";"0s";""
"773";"USDJPY_M1";"Sell";"2017.11.30 17:00:00";"112.292";"0.10000";"2017.11.30 18:00:00";"112.642";"-35.00";"15594.40";"IST";"SL";"-35.00";"0.00";"1h 0m";""
"774";"USDJPY_M1";"Buy";"2017.11.30 19:00:00";"112.574";"0.10000";"2017.12.01 16:00:00";"112.224";"-35.00";"15559.40";"IST";"SL";"-35.00";"29.90";"21h 0m";""
"775";"USDJPY_M1";"Sell";"2017.12.01 19:00:00";"112.160";"0.10000";"2017.12.01 21:00:00";"112.127";"3.30";"15562.70";"IST";"End Of Friday (Time)";"0.00";"14.10";"2h 0m";""
"776";"USDJPY_M1";"Sell";"2017.12.04 11:00:00";"112.937";"0.10000";"2017.12.08 01:00:00";"113.287";"-35.00";"15527.70";"IST";"SL";"-35.00";"92.40";"3d 14h 0m";""
"777";"USDJPY_M1";"Sell";"2017.12.08 06:00:00";"113.388";"0.10000";"2017.12.08 21:00:00";"113.509";"-12.10";"15515.60";"IST";"End Of Friday (Time)";"-22.10";"23.90";"15h 0m";""
"778";"USDJPY_M1";"Sell";"2017.12.10 22:00:00";"113.520";"0.10000";"2017.12.15 21:00:00";"112.601";"91.90";"15607.50";"IST";"End Of Friday (Time)";"-25.00";"147.00";"4d 23h 0m";""
"779";"USDJPY_M1";"Sell";"2017.12.18 01:00:00";"112.742";"0.10000";"2017.12.19 18:00:00";"113.092";"-35.00";"15572.50";"IST";"SL";"-35.00";"41.30";"1d 17h 0m";""
"780";"USDJPY_M1";"Sell";"2017.12.19 22:00:00";"112.883";"0.10000";"2017.12.20 12:00:00";"113.233";"-35.00";"15537.50";"IST";"SL";"-35.00";"2.50";"14h 0m";""
"781";"USDJPY_M1";"Sell";"2017.12.20 17:00:00";"113.293";"0.10000";"2017.12.21 08:00:00";"113.643";"-35.00";"15502.50";"IST";"SL";"-35.00";"7.40";"15h 0m";""
"782";"USDJPY_M1";"Sell";"2017.12.21 09:00:00";"113.520";"0.10000";"2017.12.22 21:00:00";"113.288";"23.20";"15525.70";"IST";"End Of Friday (Time)";"-7.40";"24.80";"1d 12h 0m";""
"783";"USDJPY_M1";"Buy";"2017.12.25 02:00:00";"113.338";"0.10000";"2017.12.28 04:00:00";"112.988";"-35.00";"15490.70";"IST";"SL";"-35.00";"4.10";"3d 2h 0m";""
"784";"USDJPY_M1";"Sell";"2017.12.28 05:00:00";"112.998";"0.10000";"2017.12.29 21:00:00";"112.700";"29.80";"15520.50";"IST";"End Of Friday (Time)";"-1.30";"50.60";"1d 16h 0m";""
"785";"USDJPY_M1";"Buy";"2018.01.01 22:00:00";"112.614";"0.10000";"2018.01.02 09:00:00";"112.264";"-35.00";"15485.50";"IST";"SL";"-35.00";"17.60";"11h 0m";""
"786";"USDJPY_M1";"Sell";"2018.01.02 11:00:00";"112.138";"0.10000";"2018.01.03 15:00:00";"112.488";"-35.00";"15450.50";"IST";"SL";"-35.00";"6.30";"1d 4h 0m";""
"787";"USDJPY_M1";"Buy";"2018.01.03 18:00:00";"112.352";"0.10000";"2018.01.05 21:00:00";"113.107";"75.50";"15526.00";"IST";"End Of Friday (Time)";"-5.40";"95.60";"2d 3h 0m";""
"788";"USDJPY_M1";"Sell";"2018.01.07 22:00:00";"113.131";"0.10000";"2018.01.10 10:00:00";"111.331";"180.00";"15706.00";"IST";"PT";"-27.50";"180.00";"2d 12h 0m";""
"789";"USDJPY_M1";"Buy";"2018.01.10 16:00:00";"111.367";"0.10000";"2018.01.12 09:00:00";"111.017";"-35.00";"15671.00";"IST";"SL";"-35.00";"50.80";"1d 17h 0m";""
"790";"USDJPY_M1";"Buy";"2018.01.12 10:00:00";"111.129";"0.10000";"2018.01.12 21:00:00";"111.038";"-9.10";"15661.90";"IST";"End Of Friday (Time)";"-21.60";"56.50";"11h 0m";""
"791";"USDJPY_M1";"Buy";"2018.01.15 01:00:00";"110.849";"0.10000";"2018.01.15 15:00:00";"110.499";"-35.00";"15626.90";"IST";"SL";"-35.00";"4.90";"14h 0m";""
"792";"USDJPY_M1";"Buy";"2018.01.15 17:00:00";"110.556";"0.10000";"2018.01.17 00:00:00";"110.206";"-35.00";"15591.90";"IST";"SL";"-35.00";"42.50";"1d 7h 0m";""
"793";"USDJPY_M1";"Buy";"2018.01.17 04:00:00";"110.657";"0.10000";"2018.01.19 21:00:00";"110.769";"11.20";"15603.10";"IST";"End Of Friday (Time)";"-16.60";"82.50";"2d 17h 0m";""
"794";"USDJPY_M1";"Buy";"2018.01.21 22:00:00";"110.596";"0.10000";"2018.01.23 22:00:00";"110.246";"-35.00";"15568.10";"IST";"SL";"-35.00";"62.70";"2d 0h 0m";""
"795";"USDJPY_M1";"Buy";"2018.01.23 23:00:00";"110.300";"0.10000";"2018.01.24 02:00:00";"109.950";"-35.00";"15533.10";"IST";"SL";"-35.00";"3.80";"3h 0m";""
"796";"USDJPY_M1";"Buy";"2018.01.24 03:00:00";"109.983";"0.10000";"2018.01.24 09:00:00";"109.633";"-35.00";"15498.10";"IST";"SL";"-35.00";"11.10";"6h 0m";""
"797";"USDJPY_M1";"Buy";"2018.01.24 10:00:00";"109.683";"0.10000";"2018.01.24 14:00:00";"109.333";"-35.00";"15463.10";"IST";"SL";"-35.00";"0.00";"4h 0m";""
"798";"USDJPY_M1";"Buy";"2018.01.24 16:00:00";"109.223";"0.10000";"2018.01.25 06:00:00";"108.873";"-35.00";"15428.10";"IST";"SL";"-35.00";"24.90";"14h 0m";""
"799";"USDJPY_M1";"Buy";"2018.01.25 09:00:00";"109.215";"0.10000";"2018.01.25 13:00:00";"108.865";"-35.00";"15393.10";"IST";"SL";"-35.00";"0.00";"4h 0m";""
"800";"USDJPY_M1";"Buy";"2018.01.25 14:00:00";"108.772";"0.10000";"2018.01.26 16:00:00";"108.422";"-35.00";"15358.10";"IST";"SL";"-35.00";"99.90";"1d 2h 0m";""
"801";"USDJPY_M1";"Sell";"2018.01.26 17:00:00";"108.386";"0.10000";"2018.01.26 19:00:00";"108.736";"-35.00";"15323.10";"IST";"SL";"-35.00";"8.30";"2h 0m";""
"802";"USDJPY_M1";"Buy";"2018.01.28 22:00:00";"108.719";"0.10000";"2018.02.02 21:00:00";"110.106";"138.70";"15461.80";"IST";"End Of Friday (Time)";"-30.70";"176.30";"4d 23h 0m";""
"803";"USDJPY_M1";"Sell";"2018.02.04 22:00:00";"110.195";"0.10000";"2018.02.09 17:00:00";"108.395";"180.00";"15641.80";"IST";"PT";"-11.40";"180.00";"4d 19h 0m";""
"804";"USDJPY_M1";"Buy";"2018.02.11 22:00:00";"108.877";"0.10000";"2018.02.12 08:00:00";"108.527";"-35.00";"15606.80";"IST";"SL";"-35.00";"1.20";"10h 0m";""
"805";"USDJPY_M1";"Buy";"2018.02.12 20:00:00";"108.694";"0.10000";"2018.02.13 04:00:00";"108.344";"-35.00";"15571.80";"IST";"SL";"-35.00";"8.50";"8h 0m";""
"806";"USDJPY_M1";"Buy";"2018.02.13 15:00:00";"107.647";"0.10000";"2018.02.14 02:00:00";"107.297";"-35.00";"15536.80";"IST";"SL";"-35.00";"25.40";"11h 0m";""
"807";"USDJPY_M1";"Buy";"2018.02.14 03:00:00";"107.234";"0.10000";"2018.02.14 03:00:00";"106.884";"-35.00";"15501.80";"IST";"SL";"-35.00";"0.00";"0s";""
"808";"USDJPY_M1";"Buy";"2018.02.14 10:00:00";"107.496";"0.10000";"2018.02.14 13:00:00";"107.146";"-35.00";"15466.80";"IST";"SL";"-35.00";"5.00";"3h 0m";""
"809";"USDJPY_M1";"Buy";"2018.02.14 17:00:00";"107.035";"0.10000";"2018.02.14 23:00:00";"106.685";"-35.00";"15431.80";"IST";"SL";"-35.00";"13.50";"6h 0m";""
"810";"USDJPY_M1";"Buy";"2018.02.15 00:00:00";"106.565";"0.10000";"2018.02.15 07:00:00";"106.215";"-35.00";"15396.80";"IST";"SL";"-35.00";"32.30";"7h 0m";""
"811";"USDJPY_M1";"Buy";"2018.02.15 08:00:00";"106.382";"0.10000";"2018.02.15 23:00:00";"106.032";"-35.00";"15361.80";"IST";"SL";"-35.00";"47.50";"15h 0m";""
"812";"USDJPY_M1";"Buy";"2018.02.16 03:00:00";"106.081";"0.10000";"2018.02.16 04:00:00";"105.731";"-35.00";"15326.80";"IST";"SL";"-35.00";"12.60";"1h 0m";""
"813";"USDJPY_M1";"Buy";"2018.02.16 10:00:00";"106.045";"0.10000";"2018.02.16 21:00:00";"106.301";"25.60";"15352.40";"IST";"End Of Friday (Time)";"-12.80";"35.30";"11h 0m";""
"814";"USDJPY_M1";"Sell";"2018.02.19 15:00:00";"106.667";"0.10000";"2018.02.20 07:00:00";"107.017";"-35.00";"15317.40";"IST";"SL";"-35.00";"15.30";"16h 0m";""
"815";"USDJPY_M1";"Sell";"2018.02.20 14:00:00";"107.321";"0.10000";"2018.02.21 01:00:00";"107.671";"-35.00";"15282.40";"IST";"SL";"-35.00";"23.10";"11h 0m";""
"816";"USDJPY_M1";"Sell";"2018.02.21 09:00:00";"107.558";"0.10000";"2018.02.21 20:00:00";"107.908";"-35.00";"15247.40";"IST";"SL";"-35.00";"25.20";"11h 0m";""
"817";"USDJPY_M1";"Buy";"2018.02.21 22:00:00";"107.792";"0.10000";"2018.02.22 00:00:00";"107.442";"-35.00";"15212.40";"IST";"SL";"-35.00";"0.00";"2h 0m";""
"818";"USDJPY_M1";"Sell";"2018.02.22 02:00:00";"107.259";"0.10000";"2018.02.22 07:00:00";"107.609";"-35.00";"15177.40";"IST";"SL";"-35.00";"0.40";"5h 0m";""
"819";"USDJPY_M1";"Buy";"2018.02.22 19:00:00";"106.846";"0.10000";"2018.02.23 21:00:00";"106.881";"3.50";"15180.90";"IST";"End Of Friday (Time)";"-33.40";"28.60";"1d 2h 0m";""
"820";"USDJPY_M1";"Buy";"2018.02.25 23:00:00";"107.071";"0.10000";"2018.02.26 01:00:00";"106.721";"-35.00";"15145.90";"IST";"SL";"-35.00";"4.20";"2h 0m";""
"821";"USDJPY_M1";"Sell";"2018.02.26 03:00:00";"106.497";"0.10000";"2018.02.26 13:00:00";"106.847";"-35.00";"15110.90";"IST";"SL";"-35.00";"10.20";"10h 0m";""
"822";"USDJPY_M1";"Sell";"2018.02.27 03:00:00";"106.955";"0.10000";"2018.02.27 15:00:00";"107.305";"-35.00";"15075.90";"IST";"SL";"-35.00";"13.30";"12h 0m";""
"823";"USDJPY_M1";"Sell";"2018.02.27 21:00:00";"107.366";"0.10000";"2018.03.02 10:00:00";"105.566";"180.00";"15255.90";"IST";"PT";"-18.00";"180.00";"2d 13h 0m";""
"824";"USDJPY_M1";"Buy";"2018.03.02 12:00:00";"105.447";"0.10000";"2018.03.02 21:00:00";"105.724";"27.70";"15283.60";"IST";"End Of Friday (Time)";"-19.70";"27.70";"9h 0m";""
"825";"USDJPY_M1";"Buy";"2018.03.04 22:00:00";"105.500";"0.10000";"2018.03.09 21:00:00";"106.812";"131.20";"15414.80";"IST";"End Of Friday (Time)";"-15.10";"154.90";"4d 23h 0m";""
"826";"USDJPY_M1";"Sell";"2018.03.11 21:00:00";"106.680";"0.10000";"2018.03.13 08:00:00";"107.030";"-35.00";"15379.80";"IST";"SL";"-35.00";"40.80";"1d 11h 0m";""
"827";"USDJPY_M1";"Buy";"2018.03.13 09:00:00";"106.945";"0.10000";"2018.03.13 15:00:00";"106.595";"-35.00";"15344.80";"IST";"SL";"-35.00";"34.60";"6h 0m";""
"828";"USDJPY_M1";"Sell";"2018.03.13 16:00:00";"106.629";"0.10000";"2018.03.18 21:00:00";"105.930";"69.90";"15414.70";"IST";"End Of Friday";"-13.90";"100.70";"5d 5h 0m";""
"829";"USDJPY_M1";"Buy";"2018.03.19 10:00:00";"106.018";"0.10000";"2018.03.22 00:00:00";"105.668";"-35.00";"15379.70";"IST";"SL";"-35.00";"62.10";"2d 14h 0m";""
"830";"USDJPY_M1";"Buy";"2018.03.22 07:00:00";"105.868";"0.10000";"2018.03.22 12:00:00";"105.518";"-35.00";"15344.70";"IST";"SL";"-35.00";"0.00";"5h 0m";""
"831";"USDJPY_M1";"Buy";"2018.03.22 14:00:00";"105.460";"0.10000";"2018.03.22 22:00:00";"105.110";"-35.00";"15309.70";"IST";"SL";"-35.00";"35.50";"8h 0m";""
"832";"USDJPY_M1";"Buy";"2018.03.23 07:00:00";"104.855";"0.10000";"2018.03.25 21:00:00";"104.639";"-21.60";"15288.10";"IST";"End Of Friday";"-21.60";"43.10";"2d 14h 0m";""
"833";"USDJPY_M1";"Buy";"2018.03.26 02:00:00";"105.002";"0.10000";"2018.03.28 17:00:00";"106.802";"180.00";"15468.10";"IST";"PT";"-14.90";"180.00";"2d 15h 0m";""
"834";"USDJPY_M1";"Sell";"2018.03.28 23:00:00";"106.820";"0.10000";"2018.04.01 21:00:00";"106.187";"63.30";"15531.40";"IST";"End Of Friday";"-13.20";"67.80";"3d 22h 0m";""
"835";"USDJPY_M1";"Buy";"2018.04.01 21:00:00";"106.187";"0.10000";"2018.04.02 17:00:00";"105.837";"-35.00";"15496.40";"IST";"SL";"-35.00";"26.10";"20h 0m";""
"836";"USDJPY_M1";"Sell";"2018.04.02 18:00:00";"105.666";"0.10000";"2018.04.03 05:00:00";"106.016";"-35.00";"15461.40";"IST";"SL";"-35.00";"0.00";"11h 0m";""
"837";"USDJPY_M1";"Buy";"2018.04.03 06:00:00";"106.006";"0.10000";"2018.04.08 21:00:00";"106.931";"92.50";"15553.90";"IST";"End Of Friday";"-24.80";"148.50";"5d 15h 0m";""
"838";"USDJPY_M1";"Buy";"2018.04.09 01:00:00";"106.907";"0.10000";"2018.04.15 21:00:00";"107.481";"57.40";"15611.30";"IST";"End Of Friday";"-29.10";"87.10";"6d 20h 0m";""
"839";"USDJPY_M1";"Sell";"2018.04.15 21:00:00";"107.481";"0.10000";"2018.04.20 14:00:00";"107.831";"-35.00";"15576.30";"IST";"SL";"-35.00";"57.80";"4d 17h 0m";""
"840";"USDJPY_M1";"Sell";"2018.04.20 17:00:00";"107.512";"0.10000";"2018.04.22 21:00:00";"107.785";"-27.30";"15549.00";"IST";"End Of Friday";"-27.30";"0.00";"2d 4h 0m";""
"841";"USDJPY_M1";"Sell";"2018.04.22 21:00:00";"107.765";"0.10000";"2018.04.23 09:00:00";"108.115";"-35.00";"15514.00";"IST";"SL";"-35.00";"8.60";"12h 0m";""
"842";"USDJPY_M1";"Sell";"2018.04.23 21:00:00";"108.699";"0.10000";"2018.04.24 12:00:00";"109.049";"-35.00";"15479.00";"IST";"SL";"-35.00";"0.90";"15h 0m";""
"843";"USDJPY_M1";"Sell";"2018.04.24 13:00:00";"108.996";"0.10000";"2018.04.25 14:00:00";"109.346";"-35.00";"15444.00";"IST";"SL";"-35.00";"43.40";"1d 1h 0m";""
"844";"USDJPY_M1";"Sell";"2018.04.25 16:00:00";"109.335";"0.10000";"2018.04.29 21:00:00";"109.077";"25.80";"15469.80";"IST";"End Of Friday";"-22.10";"35.10";"4d 5h 0m";""
"845";"USDJPY_M1";"Buy";"2018.04.30 01:00:00";"109.093";"0.10000";"2018.05.04 12:00:00";"108.743";"-35.00";"15434.80";"IST";"SL";"-35.00";"94.30";"4d 11h 0m";""
"846";"USDJPY_M1";"Buy";"2018.05.04 16:00:00";"109.187";"0.10000";"2018.05.06 21:00:00";"109.105";"-8.20";"15426.60";"IST";"End Of Friday";"-23.00";"1.50";"2d 5h 0m";""
"847";"USDJPY_M1";"Buy";"2018.05.06 22:00:00";"109.113";"0.10000";"2018.05.07 01:00:00";"108.763";"-35.00";"15391.60";"IST";"SL";"-35.00";"8.60";"3h 0m";""
"848";"USDJPY_M1";"Buy";"2018.05.07 02:00:00";"108.957";"0.10000";"2018.05.13 21:00:00";"109.308";"35.10";"15426.70";"IST";"End Of Friday";"-12.80";"106.00";"6d 19h 0m";""
"849";"USDJPY_M1";"Buy";"2018.05.14 01:00:00";"109.282";"0.10000";"2018.05.20 21:00:00";"110.867";"158.50";"15585.20";"IST";"End Of Friday";"-6.10";"179.90";"6d 20h 0m";""
"850";"USDJPY_M1";"Sell";"2018.05.21 11:00:00";"111.346";"0.10000";"2018.05.24 01:00:00";"109.546";"180.00";"15765.20";"IST";"PT";"-0.40";"180.00";"2d 14h 0m";""
"851";"USDJPY_M1";"Buy";"2018.05.24 09:00:00";"109.727";"0.10000";"2018.05.24 13:00:00";"109.377";"-35.00";"15730.20";"IST";"SL";"-35.00";"3.70";"4h 0m";""
"852";"USDJPY_M1";"Buy";"2018.05.24 14:00:00";"109.177";"0.10000";"2018.05.27 21:00:00";"109.744";"56.70";"15786.90";"IST";"End Of Friday";"-22.20";"56.70";"3d 7h 0m";""
"853";"USDJPY_M1";"Sell";"2018.05.28 03:00:00";"109.442";"0.10000";"2018.06.03 21:00:00";"109.475";"-3.30";"15783.60";"IST";"End Of Friday";"-31.10";"131.10";"6d 18h 0m";""
"854";"USDJPY_M1";"Sell";"2018.06.03 21:00:00";"109.455";"0.10000";"2018.06.04 19:00:00";"109.805";"-35.00";"15748.60";"IST";"SL";"-35.00";"6.30";"22h 0m";""
"855";"USDJPY_M1";"Sell";"2018.06.05 03:00:00";"109.885";"0.10000";"2018.06.06 11:00:00";"110.235";"-35.00";"15713.60";"IST";"SL";"-35.00";"39.30";"1d 8h 0m";""
"856";"USDJPY_M1";"Sell";"2018.06.06 15:00:00";"110.037";"0.10000";"2018.06.10 21:00:00";"109.294";"74.30";"15787.90";"IST";"End Of Friday";"-24.90";"81.90";"4d 6h 0m";""
"857";"USDJPY_M1";"Buy";"2018.06.10 21:00:00";"109.294";"0.10000";"2018.06.17 21:00:00";"110.659";"136.50";"15924.40";"IST";"End Of Friday";"0.00";"161.00";"7d 0h 0m";""
"858";"USDJPY_M1";"Sell";"2018.06.18 03:00:00";"110.427";"0.10000";"2018.06.24 21:00:00";"109.848";"57.90";"15982.30";"IST";"End Of Friday";"-34.90";"85.70";"6d 18h 0m";""
"859";"USDJPY_M1";"Buy";"2018.06.24 22:00:00";"109.921";"0.10000";"2018.06.25 01:00:00";"109.571";"-35.00";"15947.30";"IST";"SL";"-35.00";"2.80";"3h 0m";""
"860";"USDJPY_M1";"Buy";"2018.06.25 02:00:00";"109.523";"0.10000";"2018.07.01 21:00:00";"110.561";"103.80";"16051.10";"IST";"End Of Friday";"-15.60";"141.90";"6d 19h 0m";""
"861";"USDJPY_M1";"Sell";"2018.07.01 22:00:00";"110.657";"0.10000";"2018.07.02 01:00:00";"111.007";"-35.00";"16016.10";"IST";"SL";"-35.00";"0.00";"3h 0m";""
"862";"USDJPY_M1";"Sell";"2018.07.02 06:00:00";"110.692";"0.10000";"2018.07.03 01:00:00";"111.042";"-35.00";"15981.10";"IST";"SL";"-35.00";"6.90";"19h 0m";""
"863";"USDJPY_M1";"Sell";"2018.07.03 04:00:00";"110.844";"0.10000";"2018.07.08 21:00:00";"110.402";"44.20";"16025.30";"IST";"End Of Friday";"-29.20";"54.60";"5d 17h 0m";""
"864";"USDJPY_M1";"Buy";"2018.07.09 02:00:00";"110.441";"0.10000";"2018.07.12 01:00:00";"112.241";"180.00";"16205.30";"IST";"PT";"-5.60";"180.00";"2d 23h 0m";""
"865";"USDJPY_M1";"Sell";"2018.07.12 02:00:00";"112.244";"0.10000";"2018.07.12 10:00:00";"112.594";"-35.00";"16170.30";"IST";"SL";"-35.00";"5.70";"8h 0m";""
"866";"USDJPY_M1";"Sell";"2018.07.12 11:00:00";"112.604";"0.10000";"2018.07.15 21:00:00";"112.216";"38.80";"16209.10";"IST";"End Of Friday";"-21.60";"38.80";"3d 10h 0m";""
"867";"USDJPY_M1";"Buy";"2018.07.16 01:00:00";"112.498";"0.10000";"2018.07.19 17:00:00";"112.148";"-35.00";"16174.10";"IST";"SL";"-35.00";"67.50";"3d 16h 0m";""
"868";"USDJPY_M1";"Buy";"2018.07.19 18:00:00";"112.355";"0.10000";"2018.07.20 12:00:00";"112.005";"-35.00";"16139.10";"IST";"SL";"-35.00";"26.60";"18h 0m";""
"869";"USDJPY_M1";"Buy";"2018.07.20 13:00:00";"111.790";"0.10000";"2018.07.20 18:00:00";"111.440";"-35.00";"16104.10";"IST";"SL";"-35.00";"12.60";"5h 0m";""
"870";"USDJPY_M1";"Buy";"2018.07.23 05:00:00";"110.957";"0.10000";"2018.07.26 06:00:00";"110.607";"-35.00";"16069.10";"IST";"SL";"-35.00";"58.60";"3d 1h 0m";""
"871";"USDJPY_M1";"Buy";"2018.07.26 07:00:00";"110.695";"0.10000";"2018.07.29 21:00:00";"110.931";"23.60";"16092.70";"IST";"End Of Friday";"-4.40";"55.40";"3d 14h 0m";""
"872";"USDJPY_M1";"Buy";"2018.07.30 01:00:00";"111.039";"0.10000";"2018.08.05 21:00:00";"111.211";"17.20";"16109.90";"IST";"End Of Friday";"-28.90";"111.10";"6d 20h 0m";""
"873";"USDJPY_M1";"Buy";"2018.08.05 21:00:00";"111.231";"0.10000";"2018.08.08 07:00:00";"110.881";"-35.00";"16074.90";"IST";"SL";"-35.00";"29.50";"2d 10h 0m";""
"874";"USDJPY_M1";"Sell";"2018.08.08 10:00:00";"110.929";"0.10000";"2018.08.12 21:00:00";"110.445";"48.40";"16123.30";"IST";"End Of Friday";"-28.30";"48.40";"4d 11h 0m";""
"875";"USDJPY_M1";"Buy";"2018.08.12 22:00:00";"110.514";"0.10000";"2018.08.13 02:00:00";"110.164";"-35.00";"16088.30";"IST";"SL";"-35.00";"23.30";"4h 0m";""
"876";"USDJPY_M1";"Buy";"2018.08.13 08:00:00";"110.211";"0.10000";"2018.08.19 21:00:00";"110.582";"37.10";"16125.40";"IST";"End Of Friday";"0.00";"122.00";"6d 13h 0m";""
"877";"USDJPY_M1";"Buy";"2018.08.19 21:00:00";"110.602";"0.10000";"2018.08.20 17:00:00";"110.252";"-35.00";"16090.40";"IST";"SL";"-35.00";"8.20";"20h 0m";""
"878";"USDJPY_M1";"Buy";"2018.08.21 04:00:00";"110.147";"0.10000";"2018.08.26 21:00:00";"111.320";"117.30";"16207.70";"IST";"End Of Friday";"-14.20";"133.90";"5d 17h 0m";""
"879";"USDJPY_M1";"Sell";"2018.08.27 03:00:00";"111.028";"0.10000";"2018.08.29 12:00:00";"111.378";"-35.00";"16172.70";"IST";"SL";"-35.00";"5.80";"2d 9h 0m";""
"880";"USDJPY_M1";"Sell";"2018.08.29 20:00:00";"111.699";"0.10000";"2018.08.31 20:00:00";"111.085";"61.40";"16234.10";"IST";"EndTest";"-7.50";"99.50";"2d 0h 0m";""
